,Name,EX,EW,Subtotal (EX+EW),CR(PE),CR(PEW),Subtotal (EX+EW+ CR(PE)+CR(PEW)),CR,EN,VU,Subtotal (threatened spp.),LR/cd,NT or LR/nt,LC or LR/lc,DD,Total,species
0,Antarctica,0,0,0,0,0,0,0,1,7,8,0,5,162,35,210,animal
1,Bouvet Island,0,0,0,0,0,0,0,0,2,2,0,0,93,3,98,animal
2,French Southern Territories,1,0,1,0,0,1,3,10,16,29,0,7,977,54,"1,068",animal
3,Heard Island and McDonald Islands,0,0,0,0,0,0,0,4,9,13,0,1,125,6,145,animal
4,South Georgia and the South Sandwich Islands,0,0,0,0,0,0,0,4,5,9,0,6,195,12,222,animal
5,Anguilla,1,0,1,0,0,1,9,14,35,58,0,23,"1,156",67,"1,305",animal
6,Antigua and Barbuda,3,0,3,0,0,3,12,14,37,63,0,29,"1,274",68,"1,437",animal
7,Aruba,0,0,0,0,0,0,7,10,30,47,0,23,"1,111",55,"1,236",animal
8,Bahamas,2,0,2,1,0,3,14,22,52,88,0,41,"1,711",116,"1,958",animal
9,Barbados,1,0,1,3,0,4,13,14,35,62,0,32,"1,277",70,"1,442",animal
10,Bermuda,5,0,5,1,1,7,31,12,30,73,0,25,947,70,"1,120",animal
11,"Bonaire, Sint Eustatius and Saba",1,0,1,0,0,1,11,12,42,65,0,25,"1,232",75,"1,398",animal
12,Cayman Islands,2,0,2,0,0,2,11,19,32,62,0,32,"1,182",70,"1,348",animal
13,Cuba,7,0,7,3,0,10,37,69,82,188,0,69,"1,782",130,"2,176",animal
14,Curaçao,0,0,0,0,0,0,10,14,36,60,0,24,"1,125",77,"1,286",animal
15,Dominica,1,0,1,1,0,2,11,17,37,65,0,34,"1,306",72,"1,478",animal
16,Dominican Republic,9,0,9,6,0,15,32,62,66,160,0,56,"1,462",79,"1,766",animal
17,Grenada,0,0,0,0,0,0,10,14,38,62,0,28,"1,252",72,"1,414",animal
18,Guadeloupe,7,0,7,2,0,9,13,20,42,75,0,36,"1,235",70,"1,423",animal
19,Haiti,10,0,10,13,0,23,61,53,66,180,0,54,"1,406",75,"1,725",animal
20,Jamaica,3,0,3,5,0,8,25,41,45,111,0,46,"1,328",79,"1,567",animal
21,Martinique,6,0,6,3,0,9,10,15,29,54,0,27,"1,209",61,"1,357",animal
22,Montserrat,0,0,0,1,0,1,9,12,36,57,0,26,"1,169",58,"1,310",animal
23,Puerto Rico,5,0,5,4,0,9,19,23,40,82,0,41,"1,495",85,"1,708",animal
24,Saint Barthélemy,0,0,0,0,0,0,6,10,27,43,0,14,815,38,910,animal
25,Saint Kitts and Nevis,1,0,1,0,0,1,10,11,37,58,0,29,"1,225",65,"1,378",animal
26,Saint Lucia,3,0,3,0,0,3,10,21,35,66,0,31,"1,274",62,"1,436",animal
27,Saint Martin (French part),0,0,0,1,0,1,9,11,35,55,0,19,"1,038",65,"1,177",animal
28,Saint Vincent and the Grenadines,1,0,1,0,0,1,9,16,38,63,0,29,"1,302",68,"1,463",animal
29,Sint Maarten (Dutch part),0,0,0,1,0,1,9,11,35,55,0,17,"1,016",58,"1,146",animal
30,Trinidad and Tobago,0,0,0,0,0,0,14,18,49,81,1,38,"1,906",89,"2,115",animal
31,Turks and Caicos Islands,0,0,0,0,0,0,7,14,37,58,0,28,"1,195",67,"1,348",animal
32,"Virgin Islands, British",0,0,0,2,0,2,14,15,38,67,0,29,"1,263",72,"1,431",animal
33,"Virgin Islands, U.S.",1,0,1,5,0,6,11,16,30,57,0,29,"1,243",71,"1,401",animal
34,China,4,1,5,17,0,22,105,198,314,617,1,247,"4,316","1,045","6,231",animal
35,Hong Kong,0,0,0,1,0,1,13,24,40,77,1,30,940,91,"1,139",animal
36,Japan,14,1,15,1,0,16,46,149,256,451,3,267,"3,372",508,"4,616",animal
37,"Korea, Democratic People's Republic of",1,0,1,0,0,1,7,26,47,80,0,37,718,72,908,animal
38,"Korea, Republic of",1,0,1,0,0,1,12,39,61,112,0,50,"1,242",108,"1,513",animal
39,Macao,0,0,0,0,0,0,5,10,11,26,0,5,402,31,464,animal
40,Mongolia,0,0,0,0,0,0,5,11,24,40,0,29,546,10,625,animal
41,"Taiwan, Province of China",0,0,0,0,0,0,21,69,221,311,2,214,"2,997",308,"3,832",animal
42,Åland Islands,0,0,0,0,0,0,0,0,0,0,0,0,17,1,18,animal
43,Albania,1,0,1,1,0,2,19,49,72,140,0,88,"1,045",79,"1,353",animal
44,Andorra,0,0,0,0,0,0,0,3,11,14,0,20,309,7,350,animal
45,Austria,3,0,3,4,0,7,24,29,52,105,0,81,851,66,"1,106",animal
46,Belgium,1,0,1,0,0,1,6,6,32,44,0,48,704,38,835,animal
47,Bosnia and Herzegovina,0,0,0,0,0,0,9,29,62,100,0,69,908,89,"1,166",animal
48,Bulgaria,0,0,0,0,0,0,16,19,73,108,0,86,938,72,"1,204",animal
49,Croatia,1,0,1,3,0,4,34,42,105,181,0,99,"1,208",124,"1,613",animal
50,Czechia,0,0,0,0,0,0,4,10,31,45,0,55,706,39,845,animal
51,Denmark,0,0,0,0,0,0,7,9,36,52,0,42,688,32,814,animal
52,Estonia,0,0,0,0,0,0,2,4,17,23,0,29,517,9,578,animal
53,Faroe Islands,1,0,1,0,0,1,3,5,19,27,0,16,300,20,364,animal
54,Finland,0,0,0,0,0,0,4,3,23,30,0,38,537,14,619,animal
55,France,8,0,8,6,0,14,30,63,169,262,0,159,"1,943",287,"2,659",animal
56,Germany,4,0,4,5,0,9,18,29,62,109,0,83,939,82,"1,217",animal
57,Gibraltar,0,0,0,0,0,0,5,8,30,43,0,20,530,32,625,animal
58,Greece,4,0,4,11,1,16,77,114,250,441,0,161,"1,528",264,"2,398",animal
59,Greenland,1,0,1,0,0,1,2,5,20,27,0,8,217,20,273,animal
60,Guernsey,0,0,0,0,0,0,1,1,11,13,0,3,197,12,225,animal
61,Holy See (Vatican City State),0,0,0,0,0,0,0,0,2,2,0,3,21,2,28,animal
62,Hungary,0,0,0,0,0,0,7,15,41,63,0,54,693,47,857,animal
63,Iceland,1,0,1,0,0,1,5,8,20,33,0,19,353,27,433,animal
64,Ireland,1,0,1,0,0,1,9,11,37,57,0,37,768,65,928,animal
65,Isle of Man,0,0,0,0,0,0,1,2,4,7,0,3,79,6,95,animal
66,Italy,3,0,3,7,0,10,48,97,181,326,0,199,"1,619",263,"2,410",animal
67,Jersey,0,0,0,0,0,0,1,1,12,14,0,2,204,12,232,animal
68,Latvia,0,0,0,0,0,0,2,4,25,31,0,39,556,16,642,animal
69,Liechtenstein,0,0,0,0,0,0,0,1,7,8,0,24,396,7,435,animal
70,Lithuania,0,0,0,0,0,0,2,3,21,26,0,34,541,15,616,animal
71,Luxembourg,0,0,0,0,0,0,2,3,7,12,0,22,451,12,497,animal
72,Malta,0,0,0,0,0,0,8,9,31,48,0,27,563,42,680,animal
73,Monaco,0,0,0,0,0,0,6,7,23,36,0,13,382,26,457,animal
74,Montenegro,1,0,1,1,0,2,17,31,59,107,0,87,978,82,"1,255",animal
75,Netherlands,1,0,1,0,0,1,8,5,33,46,0,49,752,37,885,animal
76,North Macedonia,2,0,2,2,0,4,19,35,67,121,0,60,725,49,957,animal
77,Norway,0,0,0,0,0,0,7,11,40,58,0,46,661,30,795,animal
78,Poland,1,0,1,0,0,1,3,13,36,52,0,59,756,34,902,animal
79,Portugal,6,0,6,17,0,23,107,94,133,334,0,123,"1,698",290,"2,451",animal
80,Romania,2,0,2,2,0,4,19,28,76,123,0,74,930,74,"1,203",animal
81,San Marino,0,0,0,0,0,0,1,0,2,3,0,5,61,4,73,animal
82,Serbia,0,0,0,1,0,1,10,12,50,72,0,65,824,29,990,animal
83,Slovakia,0,0,0,0,0,0,6,12,36,54,0,60,723,44,881,animal
84,Slovenia,0,0,0,0,0,0,12,27,107,146,0,56,"1,081",85,"1,368",animal
85,Spain,2,0,2,12,0,14,77,142,230,449,0,275,"2,175",495,"3,396",animal
86,Svalbard and Jan Mayen,0,0,0,0,0,0,0,1,10,11,0,7,74,4,96,animal
87,Sweden,0,0,0,0,0,0,5,7,36,48,0,50,681,32,811,animal
88,Switzerland,6,0,6,0,0,6,4,15,53,72,0,68,782,58,986,animal
89,United Kingdom,2,0,2,0,0,2,12,21,58,91,0,60,986,72,"1,211",animal
90,Belize,1,0,1,0,0,1,11,28,58,97,0,59,"2,074",94,"2,325",animal
91,Costa Rica,4,0,4,7,0,11,35,82,154,271,0,107,"3,392",235,"4,009",animal
92,El Salvador,0,0,0,0,0,0,8,24,52,84,0,49,"1,615",84,"1,832",animal
93,Guatemala,3,0,3,5,0,8,47,88,122,257,0,83,"2,810",167,"3,320",animal
94,Honduras,4,0,4,10,0,14,62,76,107,245,0,88,"3,030",160,"3,527",animal
95,Mexico,21,9,30,35,3,68,202,343,362,907,1,217,"4,930",585,"6,670",animal
96,Nicaragua,1,0,1,0,0,1,26,31,95,152,0,82,"2,948",162,"3,345",animal
97,Panama,2,0,2,8,1,11,56,82,131,269,0,118,"3,534",296,"4,219",animal
98,Algeria,2,1,3,0,0,3,18,40,77,135,0,56,928,142,"1,264",animal
99,Egypt,1,1,2,0,0,2,15,36,129,180,2,134,"1,759",184,"2,261",animal
100,Libya,0,1,1,0,0,1,11,18,45,74,0,29,689,69,862,animal
101,Morocco,2,0,2,0,0,2,30,63,95,188,0,79,"1,458",176,"1,903",animal
102,Tunisia,11,0,11,1,0,12,16,26,61,103,0,47,856,102,"1,119",animal
103,Western Sahara,0,1,1,0,0,1,7,22,36,65,0,36,930,102,"1,134",animal
104,Canada,9,0,9,3,0,12,18,32,84,134,0,64,"1,902",87,"2,196",animal
105,Saint Pierre and Miquelon,0,0,0,0,0,0,2,4,16,22,0,16,403,17,458,animal
106,United States,237,4,241,29,0,270,224,298,566,"1,088",5,336,"5,719",609,"7,998",animal
107,Belarus,0,0,0,0,0,0,3,2,21,26,0,38,482,8,554,animal
108,Moldova,1,0,1,0,0,1,6,5,22,33,0,33,442,6,515,animal
109,Russian Federation,3,1,4,2,0,6,28,49,111,188,0,118,"1,735",233,"2,278",animal
110,Ukraine,2,0,2,1,0,3,12,26,56,94,0,66,889,78,"1,129",animal
111,American Samoa,1,0,1,0,0,1,3,20,77,100,3,82,"1,248",57,"1,491",animal
112,Australia,42,0,42,7,0,49,138,255,613,"1,006",3,442,"5,868",661,"8,022",animal
113,Christmas Island,4,2,6,1,0,7,3,16,30,49,0,29,939,31,"1,054",animal
114,Cocos (Keeling) Islands,0,0,0,0,0,0,1,13,33,47,0,26,842,31,946,animal
115,Cook Islands,15,0,15,0,0,15,1,15,53,69,1,52,"1,011",50,"1,198",animal
116,Fiji,1,0,1,5,0,6,28,52,166,246,3,163,"1,809",132,"2,354",animal
117,French Polynesia,60,11,71,2,0,73,46,26,67,139,2,62,"1,290",107,"1,671",animal
118,Guam,5,1,6,0,0,6,8,26,72,106,2,91,"1,220",105,"1,530",animal
119,Kiribati,1,0,1,0,0,1,0,17,96,113,3,117,"1,277",63,"1,574",animal
120,Marshall Islands,0,0,0,0,0,0,1,14,94,109,3,118,"1,325",63,"1,618",animal
121,"Micronesia, Federated States of",2,0,2,1,0,3,6,29,139,174,3,148,"1,641",126,"2,094",animal
122,Nauru,0,0,0,0,0,0,1,10,79,90,0,110,"1,032",39,"1,271",animal
123,New Caledonia,5,0,5,3,0,8,41,56,159,256,3,163,"2,187",182,"2,796",animal
124,New Zealand,23,0,23,7,0,30,45,77,109,231,0,66,"1,066",210,"1,596",animal
125,Niue,0,0,0,0,0,0,1,13,44,58,0,54,885,34,"1,031",animal
126,Norfolk Island,8,0,8,0,0,8,2,11,36,49,0,28,637,27,749,animal
127,Northern Mariana Islands,2,0,2,0,0,2,9,24,72,105,3,91,"1,293",70,"1,564",animal
128,Palau,1,0,1,13,0,14,28,35,128,191,4,146,"1,884",107,"2,333",animal
129,Papua New Guinea,1,0,1,2,0,3,49,87,301,437,3,284,"4,051",525,"5,301",animal
130,Pitcairn,0,0,0,0,0,0,1,8,28,37,1,25,523,27,613,animal
131,Samoa,2,0,2,0,0,2,5,20,75,100,3,85,"1,344",78,"1,612",animal
132,Solomon Islands,2,0,2,3,0,5,15,39,189,243,3,201,"2,210",145,"2,804",animal
133,Tokelau,0,0,0,0,0,0,1,11,46,58,2,58,899,34,"1,051",animal
134,Tonga,2,0,2,2,0,4,5,20,68,93,3,70,"1,418",59,"1,645",animal
135,Tuvalu,0,0,0,0,0,0,1,14,87,102,3,113,"1,094",46,"1,358",animal
136,United States Minor Outlying Islands,1,0,1,0,0,1,4,9,63,76,1,75,"1,256",53,"1,462",animal
137,Vanuatu,1,0,1,0,0,1,2,23,114,139,3,135,"1,804",96,"2,178",animal
138,Wallis and Futuna,0,0,0,0,0,0,2,13,78,93,0,94,"1,201",50,"1,438",animal
139,Argentina,3,3,6,6,0,12,41,69,118,228,0,127,"2,211",178,"2,750",animal
140,"Bolivia, Plurinational States of",0,0,0,9,0,9,35,34,88,157,2,98,"2,312",132,"2,701",animal
141,Brazil,11,2,13,11,0,24,105,144,287,536,9,230,"4,768",700,"6,256",animal
142,Chile,1,0,1,3,0,4,25,62,81,168,0,84,"1,302",201,"1,756",animal
143,Colombia,1,0,1,40,2,43,126,227,361,714,2,259,"5,283",586,"6,845",animal
144,Ecuador,8,0,8,41,0,49,112,164,296,572,2,207,"3,527",371,"4,687",animal
145,Falkland Islands (Malvinas),1,0,1,0,0,1,0,8,11,19,0,10,281,17,328,animal
146,French Guiana,0,0,0,0,0,0,13,16,45,74,1,46,"2,081",93,"2,295",animal
147,Guyana,0,0,0,0,0,0,14,28,61,103,2,57,"2,281",109,"2,552",animal
148,Paraguay,0,3,3,2,0,5,7,12,30,49,0,61,"1,106",38,"1,257",animal
149,Peru,1,0,1,10,0,11,58,155,209,422,2,204,"3,891",474,"4,994",animal
150,Suriname,0,0,0,0,0,0,10,17,45,72,0,53,"2,141",95,"2,361",animal
151,Uruguay,2,0,2,2,0,4,21,30,60,111,0,51,988,64,"1,216",animal
152,"Venezuela, Bolivarian Republic of",1,0,1,11,0,12,58,108,170,336,1,168,"3,758",316,"4,580",animal
153,Bangladesh,0,1,1,0,0,1,31,54,76,161,0,78,"1,617",107,"1,964",animal
154,Bhutan,0,0,0,0,0,0,7,17,34,58,0,40,714,6,818,animal
155,British Indian Ocean Territory,0,0,0,0,0,0,3,14,78,95,2,103,"1,063",46,"1,309",animal
156,Brunei Darussalam,0,0,0,0,0,0,13,42,84,139,0,126,"1,588",87,"1,940",animal
157,Cambodia,0,0,0,1,0,1,35,60,160,255,0,169,"2,157",187,"2,768",animal
158,Disputed Territory,0,0,0,0,0,0,1,5,14,20,0,5,"1,086",34,"1,145",animal
159,India,0,0,0,7,0,7,94,230,398,722,2,331,"4,332",868,"6,255",animal
160,Indonesia,3,0,3,23,3,29,185,323,654,"1,162",4,640,"6,307","1,392","9,508",animal
161,Lao People's Democratic Republic,1,0,1,2,0,3,34,58,101,193,0,95,"1,530",223,"2,042",animal
162,Malaysia,1,0,1,14,0,15,96,183,434,713,3,442,"4,168",504,"5,831",animal
163,Maldives,0,0,0,0,0,0,6,22,59,87,2,94,"1,347",70,"1,600",animal
164,Myanmar,0,0,0,1,0,1,38,85,177,300,3,258,"3,226",434,"4,221",animal
165,Nepal,0,0,0,0,0,0,14,25,54,93,0,66,"1,271",65,"1,495",animal
166,Philippines,15,0,15,3,0,18,54,184,409,647,5,352,"3,652",597,"5,268",animal
167,Singapore,1,0,1,1,0,2,21,49,208,278,3,229,"1,853",154,"2,518",animal
168,Sri Lanka,18,0,18,9,0,27,88,134,155,377,2,177,"2,044",165,"2,783",animal
169,Thailand,2,0,2,5,0,7,58,122,341,521,2,366,"3,974",528,"5,393",animal
170,Timor-Leste,0,0,0,0,0,0,8,16,20,44,0,36,"1,393",59,"1,532",animal
171,Viet Nam,1,0,1,9,0,10,74,151,280,505,2,253,"3,392",640,"4,793",animal
172,Angola,0,0,0,0,0,0,16,44,78,138,0,66,"2,655",228,"3,087",animal
173,Benin,0,0,0,0,0,0,15,26,51,92,0,48,"1,748",107,"1,995",animal
174,Botswana,0,0,0,0,0,0,4,11,17,32,0,27,"1,111",9,"1,179",animal
175,Burkina Faso,0,1,1,0,0,1,7,11,12,30,0,18,817,9,875,animal
176,Burundi,0,0,0,0,0,0,6,19,32,57,0,38,"1,072",36,"1,203",animal
177,Cabo Verde,1,0,1,0,0,1,9,22,39,70,0,30,905,95,"1,101",animal
178,Cameroon,0,0,0,6,0,6,67,117,118,302,0,78,"2,704",209,"3,293",animal
179,Central African Republic,0,0,0,0,0,0,9,13,24,46,0,27,"1,408",50,"1,531",animal
180,Chad,0,1,1,1,0,2,11,11,23,45,0,20,860,13,939,animal
181,Comoros,0,0,0,1,0,1,7,29,87,123,0,112,"1,344",77,"1,656",animal
182,Congo,0,0,0,0,0,0,10,25,67,102,0,50,"2,038",142,"2,332",animal
183,"Congo, The Democratic Republic of the",0,0,0,4,0,4,31,84,152,267,0,98,"3,700",423,"4,488",animal
184,Côte d'Ivoire,0,0,0,2,0,2,19,49,84,152,0,80,"2,075",138,"2,445",animal
185,Djibouti,0,0,0,0,0,0,11,18,86,115,0,119,"1,463",112,"1,809",animal
186,Equatorial Guinea,0,0,0,0,0,0,16,35,57,108,0,42,"1,593",113,"1,856",animal
187,Eritrea,0,0,0,0,0,0,16,27,104,147,0,134,"1,607",118,"2,006",animal
188,Eswatini,0,0,0,0,0,0,4,10,17,31,0,20,883,6,940,animal
189,Ethiopia,0,0,0,2,0,2,17,41,60,118,0,44,"1,402",63,"1,627",animal
190,Gabon,0,0,0,0,0,0,12,37,69,118,0,50,"2,078",165,"2,411",animal
191,Gambia,0,0,0,0,0,0,16,23,50,89,0,48,"1,551",112,"1,800",animal
192,Ghana,0,0,0,2,0,2,27,35,79,141,0,76,"2,157",132,"2,506",animal
193,Guinea,0,0,0,1,0,1,21,58,101,180,0,75,"2,061",148,"2,464",animal
194,Guinea-Bissau,0,0,0,0,0,0,13,22,50,85,0,45,"1,522",111,"1,763",animal
195,Kenya,2,0,2,18,0,20,56,70,160,286,2,181,"3,388",243,"4,102",animal
196,Lesotho,0,0,0,0,0,0,0,8,8,16,0,19,423,3,461,animal
197,Liberia,0,0,0,2,0,2,22,43,74,139,0,68,"1,809",128,"2,144",animal
198,Madagascar,13,0,13,9,0,22,150,318,321,789,2,284,"2,391",433,"3,912",animal
199,Malawi,1,0,1,5,0,6,28,28,35,91,0,66,"1,569",59,"1,786",animal
200,Mali,0,1,1,0,0,1,7,12,24,43,0,21,986,13,"1,064",animal
201,Mauritania,0,1,1,0,0,1,15,28,61,104,0,52,"1,449",119,"1,725",animal
202,Mauritius,44,0,44,1,0,45,19,43,124,186,2,117,"1,485",139,"1,973",animal
203,Mayotte,5,0,5,0,0,5,2,18,83,103,0,110,"1,208",59,"1,485",animal
204,Mozambique,1,0,1,2,0,3,22,63,151,236,2,187,"3,344",223,"3,993",animal
205,Namibia,1,0,1,0,0,1,10,33,55,98,0,53,"1,930",96,"2,178",animal
206,Niger,0,1,1,0,0,1,6,11,20,37,0,19,733,7,797,animal
207,Nigeria,0,1,1,3,0,4,28,61,89,178,0,74,"2,500",152,"2,905",animal
208,Réunion,20,0,20,1,0,21,10,26,94,130,0,100,"1,303",94,"1,647",animal
209,Rwanda,1,0,1,0,0,1,11,16,31,58,0,32,"1,029",19,"1,139",animal
210,"Saint Helena, Ascension and Tristan da Cunha",28,0,28,13,0,41,46,58,39,143,0,17,611,52,851,animal
211,Sao Tome and Principe,0,0,0,0,0,0,9,21,31,61,0,17,741,97,916,animal
212,Senegal,0,1,1,0,0,1,19,42,73,134,0,64,"1,885",152,"2,236",animal
213,Seychelles,20,0,20,29,0,49,86,158,152,396,2,125,"1,623",114,"2,280",animal
214,Sierra Leone,0,0,0,1,0,1,20,39,72,131,0,67,"1,867",140,"2,205",animal
215,Somalia,0,0,0,1,0,1,16,35,108,159,0,144,"2,307",188,"2,798",animal
216,South Africa,6,0,6,6,0,12,85,178,213,476,2,189,"3,720",340,"4,733",animal
217,South Sudan,0,0,0,0,0,0,6,16,22,44,0,20,"1,117",21,"1,202",animal
218,Sudan,0,1,1,0,0,1,18,28,100,146,0,130,"2,161",135,"2,573",animal
219,"Tanzania, United Republic of",2,1,3,61,1,65,128,158,261,547,0,221,"3,994",351,"5,116",animal
220,Togo,0,0,0,1,0,1,18,20,48,86,0,45,"1,764",105,"2,000",animal
221,Uganda,0,0,0,28,0,28,49,39,73,161,0,58,"1,874",125,"2,218",animal
222,Zambia,0,0,0,0,0,0,10,26,40,76,0,40,"1,868",71,"2,055",animal
223,Zimbabwe,0,0,0,1,0,1,9,15,27,51,0,32,"1,424",26,"1,533",animal
224,Afghanistan,0,0,0,0,0,0,4,9,24,37,0,27,590,21,675,animal
225,Armenia,0,0,0,0,0,0,7,8,26,41,0,38,471,18,568,animal
226,Azerbaijan,0,1,1,2,0,3,13,10,31,54,0,41,583,45,724,animal
227,Bahrain,0,0,0,0,0,0,10,10,30,50,0,53,642,31,776,animal
228,Cyprus,0,0,0,1,0,1,10,21,35,66,0,37,650,66,819,animal
229,Georgia,0,0,0,0,0,0,7,10,39,56,0,47,601,24,728,animal
230,"Iran, Islamic Republic of",0,1,1,1,0,2,23,40,94,157,0,98,"1,698",163,"2,117",animal
231,Iraq,0,0,0,1,0,1,12,16,53,81,0,71,935,48,"1,135",animal
232,Israel,4,0,4,0,0,4,23,46,122,191,0,135,"1,601",154,"2,085",animal
233,Jordan,0,0,0,0,0,0,4,26,88,118,0,118,"1,253",97,"1,586",animal
234,Kazakhstan,1,1,2,2,0,4,15,19,44,78,0,38,760,60,938,animal
235,Kuwait,1,0,1,0,0,1,8,13,39,60,0,55,753,35,904,animal
236,Kyrgyzstan,0,0,0,0,0,0,1,12,26,39,0,24,461,14,538,animal
237,Lebanon,0,0,0,0,0,0,9,27,47,83,0,40,722,69,914,animal
238,Oman,0,0,0,1,0,1,13,34,70,117,0,94,"1,581",129,"1,921",animal
239,Pakistan,0,0,0,1,0,1,20,46,89,155,0,97,"1,667",96,"2,015",animal
240,"Palestine, State of",0,0,0,0,0,0,4,13,17,34,0,22,366,21,443,animal
241,Qatar,0,0,0,0,0,0,11,10,36,57,0,54,666,25,802,animal
242,Saudi Arabia,1,0,1,0,0,1,13,34,106,153,2,139,"1,602",151,"2,048",animal
243,Syrian Arab Republic,1,0,1,6,0,7,18,37,65,120,0,51,857,90,"1,119",animal
244,Tajikistan,0,0,0,1,0,1,3,9,24,36,0,21,460,26,543,animal
245,Turkey,4,0,4,12,0,16,69,108,124,301,0,104,"1,295",196,"1,900",animal
246,Turkmenistan,0,1,1,1,0,2,11,14,30,55,0,29,573,44,702,animal
247,United Arab Emirates,0,0,0,0,0,0,10,25,45,80,0,57,"1,072",58,"1,267",animal
248,Uzbekistan,0,0,0,2,0,2,9,10,28,47,0,28,505,22,602,animal
249,Yemen,2,0,2,1,0,3,11,34,118,163,0,154,"1,909",185,"2,413",animal
0,Antarctica,0,0,0,0,0,0,0,0,0,0,0,0,0,0,0,plant
1,Bouvet Island,0,0,0,0,0,0,0,0,0,0,0,0,1,0,1,plant
2,French Southern Territories,0,0,0,0,0,0,0,1,0,1,0,0,7,0,8,plant
3,Heard Island and McDonald Islands,0,0,0,0,0,0,0,0,0,0,0,0,1,0,1,plant
4,South Georgia and the South Sandwich Islands,0,0,0,0,0,0,0,0,0,0,0,0,7,0,7,plant
5,Anguilla,0,0,0,0,0,0,1,1,1,3,0,0,96,0,99,plant
6,Antigua and Barbuda,0,0,0,0,0,0,0,2,1,3,0,1,180,1,185,plant
7,Aruba,0,0,0,0,0,0,0,2,3,5,0,1,65,0,71,plant
8,Bahamas,0,0,0,0,0,0,2,13,6,21,0,10,235,3,269,plant
9,Barbados,0,0,0,0,0,0,0,1,3,4,0,0,138,2,144,plant
10,Bermuda,0,1,1,0,0,1,2,5,1,8,0,1,42,1,53,plant
11,"Bonaire, Sint Eustatius and Saba",0,0,0,0,0,0,0,2,4,6,0,1,151,0,158,plant
12,Cayman Islands,0,0,0,0,0,0,11,7,5,23,0,4,163,3,193,plant
13,Cuba,8,1,9,0,0,9,31,66,90,187,0,13,539,4,752,plant
14,Curaçao,0,0,0,0,0,0,0,1,3,4,0,1,88,0,93,plant
15,Dominica,0,0,0,0,0,0,1,3,8,12,0,3,234,3,252,plant
16,Dominican Republic,0,0,0,1,0,1,7,16,30,53,0,8,428,8,497,plant
17,Grenada,0,0,0,0,0,0,0,1,3,4,0,3,173,0,180,plant
18,Guadeloupe,0,0,0,0,0,0,0,3,8,11,0,2,243,2,258,plant
19,Haiti,1,0,1,18,0,19,52,44,39,135,0,7,406,20,569,plant
20,Jamaica,2,0,2,0,0,2,43,54,118,215,0,76,416,7,716,plant
21,Martinique,0,0,0,0,0,0,0,3,7,10,0,3,237,2,252,plant
22,Montserrat,0,0,0,1,0,1,3,1,3,7,0,1,156,0,164,plant
23,Puerto Rico,0,0,0,0,0,0,23,23,22,68,0,17,396,4,485,plant
24,Saint Barthélemy,0,0,0,0,0,0,0,1,1,2,0,1,86,0,89,plant
25,Saint Kitts and Nevis,0,0,0,0,0,0,0,0,2,2,0,1,128,2,133,plant
26,Saint Lucia,0,0,0,0,0,0,0,2,6,8,0,3,207,1,219,plant
27,Saint Martin (French part),0,0,0,0,0,0,0,2,1,3,0,1,118,1,123,plant
28,Saint Vincent and the Grenadines,0,0,0,0,0,0,0,1,4,5,0,3,220,2,230,plant
29,Sint Maarten (Dutch part),0,0,0,0,0,0,0,2,0,2,0,1,67,0,70,plant
30,Trinidad and Tobago,0,0,0,6,0,6,15,20,15,50,0,8,479,7,544,plant
31,Turks and Caicos Islands,0,0,0,0,0,0,1,7,1,9,0,2,107,1,119,plant
32,"Virgin Islands, British",0,0,0,0,0,0,2,15,7,24,0,12,180,0,216,plant
33,"Virgin Islands, U.S.",0,0,0,0,0,0,2,10,8,20,0,12,201,0,233,plant
34,China,3,0,3,8,4,15,113,291,262,666,4,98,"2,349",202,"3,322",plant
35,Hong Kong,0,0,0,0,0,0,3,6,5,14,0,5,295,2,316,plant
36,Japan,0,0,0,0,0,0,14,22,18,54,0,17,704,29,804,plant
37,"Korea, Democratic People's Republic of",0,0,0,0,0,0,1,11,7,19,0,3,267,14,303,plant
38,"Korea, Republic of",0,0,0,0,0,0,6,20,11,37,0,7,340,9,393,plant
39,Macao,0,0,0,0,0,0,0,0,0,0,0,0,27,0,27,plant
40,Mongolia,0,0,0,0,0,0,0,0,0,0,0,1,217,10,228,plant
41,"Taiwan, Province of China",0,1,1,2,1,4,16,41,31,88,1,14,591,16,711,plant
42,Åland Islands,0,0,0,0,0,0,0,0,1,1,0,0,12,0,13,plant
43,Albania,0,0,0,0,0,0,1,0,4,5,0,6,489,32,532,plant
44,Andorra,0,0,0,0,0,0,0,0,1,1,0,1,124,7,133,plant
45,Austria,0,0,0,0,0,0,6,17,15,38,0,10,479,30,557,plant
46,Belgium,0,1,1,0,0,1,0,1,2,3,0,5,368,13,390,plant
47,Bosnia and Herzegovina,0,0,0,0,0,0,1,2,2,5,0,7,370,22,404,plant
48,Bulgaria,0,0,0,0,0,0,1,4,8,13,0,10,510,47,580,plant
49,Croatia,1,0,1,0,0,1,1,6,4,11,0,11,513,36,572,plant
50,Czechia,0,0,0,0,0,0,10,14,7,31,0,5,408,25,469,plant
51,Denmark,0,0,0,0,0,0,0,0,2,2,0,4,321,9,336,plant
52,Estonia,0,0,0,0,0,0,1,0,1,2,0,1,256,4,263,plant
53,Faroe Islands,0,0,0,0,0,0,0,0,1,1,0,0,89,0,90,plant
54,Finland,0,0,0,0,0,0,0,1,3,4,0,2,330,10,346,plant
55,France,1,1,2,0,0,2,8,22,33,63,0,42,798,40,945,plant
56,Germany,0,0,0,0,0,0,17,18,16,51,0,14,485,25,575,plant
57,Gibraltar,0,0,0,0,0,0,0,0,1,1,0,0,37,1,39,plant
58,Greece,0,0,0,1,0,1,17,28,32,77,0,31,607,76,791,plant
59,Greenland,0,0,0,0,0,0,0,0,1,1,0,0,124,0,125,plant
60,Guernsey,0,0,0,0,0,0,0,0,0,0,0,0,66,0,66,plant
61,Holy See (Vatican City State),0,0,0,0,0,0,0,0,0,0,0,0,12,0,12,plant
62,Hungary,0,0,0,0,0,0,13,14,18,45,0,5,396,30,476,plant
63,Iceland,0,0,0,0,0,0,0,0,0,0,0,0,145,2,147,plant
64,Ireland,0,0,0,0,0,0,2,2,4,8,0,10,311,3,332,plant
65,Isle of Man,0,0,0,0,0,0,0,1,0,1,0,0,71,0,72,plant
66,Italy,0,0,0,1,0,1,41,42,38,121,0,55,810,68,"1,054",plant
67,Jersey,0,0,0,0,0,0,0,0,0,0,0,0,70,0,70,plant
68,Latvia,0,0,0,0,0,0,1,0,0,1,0,2,237,6,246,plant
69,Liechtenstein,0,0,0,0,0,0,0,1,0,1,0,1,205,10,217,plant
70,Lithuania,0,0,0,0,0,0,0,1,1,2,0,2,239,8,251,plant
71,Luxembourg,0,1,1,0,0,1,0,1,2,3,0,2,229,9,244,plant
72,Malta,0,0,0,0,0,0,2,1,1,4,0,3,168,8,183,plant
73,Monaco,0,0,0,0,0,0,0,1,1,2,0,0,39,1,42,plant
74,Montenegro,0,0,0,0,0,0,1,2,3,6,0,10,371,17,404,plant
75,Netherlands,0,0,0,0,0,0,0,1,2,3,0,2,342,10,357,plant
76,North Macedonia,0,0,0,0,0,0,0,2,4,6,0,6,375,31,418,plant
77,Norway,0,0,0,0,0,0,1,8,11,20,0,6,371,10,407,plant
78,Poland,0,0,0,0,0,0,1,4,11,16,0,10,418,16,460,plant
79,Portugal,3,0,3,0,0,3,33,54,57,144,0,59,576,44,826,plant
80,Romania,0,0,0,0,0,0,1,8,5,14,0,10,453,44,521,plant
81,San Marino,0,0,0,0,0,0,0,0,0,0,0,0,31,0,31,plant
82,Serbia,0,0,0,0,0,0,0,6,3,9,0,10,416,37,472,plant
83,Slovakia,0,0,0,0,0,0,9,13,10,32,0,7,330,32,401,plant
84,Slovenia,0,0,0,0,0,0,1,5,7,13,0,10,449,25,497,plant
85,Spain,1,1,2,1,0,3,81,110,90,281,2,85,851,47,"1,268",plant
86,Svalbard and Jan Mayen,0,0,0,0,0,0,0,1,0,1,0,0,42,0,43,plant
87,Sweden,0,0,0,0,0,0,0,4,6,10,0,9,404,14,437,plant
88,Switzerland,0,0,0,0,0,0,3,7,10,20,0,10,460,21,511,plant
89,United Kingdom,0,1,1,0,0,1,21,16,16,53,0,13,420,17,504,plant
90,Belize,0,0,0,0,0,0,3,28,27,58,0,11,832,4,905,plant
91,Costa Rica,0,0,0,0,0,0,14,67,100,181,2,63,"1,767",22,"2,035",plant
92,El Salvador,0,0,0,0,0,0,3,14,27,44,0,8,674,10,736,plant
93,Guatemala,0,0,0,0,0,0,17,70,81,168,2,30,"1,205",19,"1,424",plant
94,Honduras,0,1,1,0,0,1,43,59,41,143,1,24,"1,173",6,"1,348",plant
95,Mexico,2,3,5,5,3,13,162,460,358,980,5,115,"2,370",143,"3,618",plant
96,Nicaragua,0,0,0,0,0,0,4,23,29,56,1,30,"1,280",6,"1,373",plant
97,Panama,0,0,0,0,1,1,21,82,107,210,2,63,"1,806",65,"2,146",plant
98,Algeria,0,0,0,0,0,0,6,9,15,30,0,33,442,15,520,plant
99,Egypt,0,0,0,0,0,0,2,5,1,8,0,2,323,5,338,plant
100,Libya,0,0,0,0,0,0,1,2,6,9,0,7,220,3,239,plant
101,Morocco,0,0,0,0,0,0,4,26,27,57,0,44,474,18,593,plant
102,Tunisia,0,0,0,0,0,0,3,3,6,12,0,24,306,9,351,plant
103,Western Sahara,0,0,0,0,0,0,0,0,0,0,0,0,32,0,32,plant
104,Canada,1,0,1,0,0,1,6,6,9,21,0,17,992,13,"1,044",plant
105,Saint Pierre and Miquelon,0,0,0,0,0,0,0,0,0,0,0,0,50,0,50,plant
106,United States,34,5,39,14,12,65,306,197,127,630,0,74,"1,935",36,"2,714",plant
107,Belarus,0,0,0,0,0,0,1,1,0,2,0,2,243,13,260,plant
108,Moldova,0,0,0,0,0,0,0,0,2,2,0,4,208,13,227,plant
109,Russian Federation,0,0,0,0,0,0,8,30,28,66,0,22,677,57,822,plant
110,Ukraine,1,0,1,0,0,1,3,14,12,29,0,8,433,51,522,plant
111,American Samoa,0,0,0,0,0,0,0,1,1,2,0,4,74,0,80,plant
112,Australia,3,0,3,2,0,5,92,266,382,740,3,245,"2,512",76,"3,579",plant
113,Christmas Island,0,0,0,0,0,0,0,0,2,2,0,0,43,0,45,plant
114,Cocos (Keeling) Islands,0,0,0,0,0,0,0,0,0,0,0,0,19,0,19,plant
115,Cook Islands,1,0,1,0,0,1,8,2,2,12,0,0,49,3,65,plant
116,Fiji,1,0,1,0,1,2,30,24,36,90,0,17,236,21,365,plant
117,French Polynesia,2,1,3,0,0,3,29,5,18,52,0,16,119,35,225,plant
118,Guam,0,0,0,0,0,0,1,2,2,5,0,1,45,1,52,plant
119,Kiribati,0,0,0,0,0,0,0,0,0,0,0,0,29,0,29,plant
120,Marshall Islands,0,0,0,0,0,0,0,0,0,0,0,1,33,0,34,plant
121,"Micronesia, Federated States of",0,0,0,0,0,0,1,3,3,7,0,4,113,2,126,plant
122,Nauru,0,0,0,0,0,0,0,0,0,0,0,0,20,0,20,plant
123,New Caledonia,4,0,4,9,0,13,134,235,223,592,5,143,491,40,"1,275",plant
124,New Zealand,6,0,6,0,0,6,4,5,12,21,2,19,124,2,174,plant
125,Niue,0,0,0,0,0,0,0,1,0,1,0,0,41,0,42,plant
126,Norfolk Island,1,0,1,0,0,1,1,0,1,2,0,0,16,0,19,plant
127,Northern Mariana Islands,0,0,0,0,0,0,2,2,2,6,0,1,56,0,63,plant
128,Palau,0,0,0,0,0,0,0,2,3,5,0,3,96,2,106,plant
129,Papua New Guinea,0,0,0,22,1,23,103,180,211,494,0,99,"1,417",321,"2,331",plant
130,Pitcairn,0,1,1,0,0,1,2,2,5,9,0,0,23,0,33,plant
131,Samoa,0,0,0,1,0,1,3,2,2,7,0,4,101,0,112,plant
132,Solomon Islands,0,0,0,0,0,0,0,6,20,26,0,19,329,21,395,plant
133,Tokelau,0,0,0,0,0,0,0,0,0,0,0,0,10,0,10,plant
134,Tonga,0,0,0,0,0,0,1,2,4,7,0,1,103,1,112,plant
135,Tuvalu,0,0,0,0,0,0,0,0,0,0,0,0,22,0,22,plant
136,United States Minor Outlying Islands,0,0,0,0,0,0,0,0,0,0,0,0,23,0,23,plant
137,Vanuatu,0,0,0,0,0,0,1,4,5,10,1,9,159,2,181,plant
138,Wallis and Futuna,0,0,0,0,0,0,0,0,1,1,0,1,55,0,57,plant
139,Argentina,0,1,1,0,0,1,7,21,44,72,0,23,777,22,895,plant
140,"Bolivia, Plurinational States of",1,3,4,0,1,5,15,86,127,228,1,46,"1,968",67,"2,314",plant
141,Brazil,5,3,8,7,2,17,184,431,353,968,22,164,"3,774",247,"5,183",plant
142,Chile,1,3,4,0,0,4,23,30,33,86,1,18,242,7,358,plant
143,Colombia,2,4,6,1,1,8,169,299,245,713,3,131,"3,317",98,"4,268",plant
144,Ecuador,3,6,9,48,0,57,271,743,955,"1,969",1,279,"2,130",336,"4,724",plant
145,Falkland Islands (Malvinas),0,0,0,0,0,0,0,5,0,5,0,1,20,1,27,plant
146,French Guiana,0,0,0,0,0,0,4,3,13,20,1,4,"1,224",16,"1,265",plant
147,Guyana,0,0,0,0,0,0,3,9,23,35,1,11,"1,452",22,"1,521",plant
148,Paraguay,0,0,0,0,0,0,3,6,11,20,0,10,564,11,605,plant
149,Peru,1,3,4,0,0,4,40,132,300,472,4,72,"2,355",124,"3,031",plant
150,Suriname,0,0,0,0,0,0,1,3,25,29,0,5,"1,175",13,"1,222",plant
151,Uruguay,0,0,0,0,0,0,4,5,13,22,0,2,254,6,284,plant
152,"Venezuela, Bolivarian Republic of",0,0,0,1,0,1,29,45,94,168,1,75,"2,470",142,"2,856",plant
153,Bangladesh,0,0,0,0,0,0,5,9,15,29,0,11,578,14,632,plant
154,Bhutan,1,0,1,1,0,2,13,19,16,48,0,15,577,31,672,plant
155,British Indian Ocean Territory,0,0,0,0,0,0,0,0,0,0,0,1,19,0,20,plant
156,Brunei Darussalam,0,0,0,0,0,0,10,47,113,170,3,80,411,10,674,plant
157,Cambodia,0,0,0,0,0,0,3,19,20,42,0,19,578,19,658,plant
158,Disputed Territory,0,0,0,0,0,0,0,0,0,0,0,0,4,0,4,plant
159,India,2,2,4,1,0,5,93,197,159,449,1,66,"1,617",98,"2,235",plant
160,Indonesia,1,2,3,22,0,25,144,241,378,763,4,208,"2,023",267,"3,268",plant
161,Lao People's Democratic Republic,0,0,0,0,0,0,5,30,32,67,0,19,714,39,839,plant
162,Malaysia,1,1,2,21,2,25,183,295,684,"1,162",98,213,"1,622",120,"3,217",plant
163,Maldives,0,0,0,0,0,0,0,0,0,0,0,0,51,0,51,plant
164,Myanmar,0,0,0,3,0,3,14,42,33,89,0,39,"1,134",46,"1,308",plant
165,Nepal,0,0,0,0,0,0,2,9,11,22,0,5,693,15,735,plant
166,Philippines,0,0,0,6,0,6,205,236,160,601,3,95,961,48,"1,708",plant
167,Singapore,0,0,0,0,0,0,11,17,41,69,8,32,428,9,546,plant
168,Sri Lanka,1,1,2,1,0,3,83,79,136,298,3,9,630,6,948,plant
169,Thailand,0,0,0,0,0,0,18,80,98,196,2,68,"1,353",94,"1,713",plant
170,Timor-Leste,0,0,0,0,0,0,1,3,1,5,0,2,194,2,203,plant
171,Viet Nam,0,1,1,2,1,4,64,100,114,278,1,55,"1,305",99,"1,739",plant
172,Angola,0,0,0,1,0,1,2,10,37,49,0,20,"1,273",63,"1,405",plant
173,Benin,0,0,0,0,0,0,0,4,14,18,0,7,833,1,859,plant
174,Botswana,0,0,0,0,0,0,0,1,2,3,0,2,606,9,620,plant
175,Burkina Faso,0,0,0,0,0,0,0,2,3,5,0,3,604,3,615,plant
176,Burundi,0,0,0,16,1,17,22,63,49,134,1,18,674,9,836,plant
177,Cabo Verde,2,0,2,0,0,2,17,27,7,51,0,7,80,9,149,plant
178,Cameroon,1,0,1,8,1,10,138,225,326,689,2,76,"1,461",32,"2,261",plant
179,Central African Republic,0,0,0,0,0,0,2,13,22,37,1,10,968,7,"1,023",plant
180,Chad,0,0,0,0,0,0,1,2,4,7,0,2,567,4,580,plant
181,Comoros,0,0,0,0,0,0,2,5,5,12,0,0,143,0,155,plant
182,Congo,0,0,0,0,0,0,1,19,48,68,1,15,977,5,"1,066",plant
183,"Congo, The Democratic Republic of the",2,0,2,4,0,6,16,86,143,245,3,50,"1,636",43,"1,979",plant
184,Côte d'Ivoire,2,0,2,1,0,3,5,30,104,139,1,36,"1,075",10,"1,263",plant
185,Djibouti,0,0,0,0,0,0,0,2,1,3,0,0,121,0,124,plant
186,Equatorial Guinea,0,0,0,0,0,0,2,38,78,118,0,31,628,8,785,plant
187,Eritrea,0,0,0,0,0,0,0,2,4,6,0,6,262,2,276,plant
188,Eswatini,0,1,1,0,0,1,2,4,9,15,0,5,517,4,542,plant
189,Ethiopia,0,0,0,3,0,3,10,26,29,65,1,29,895,19,"1,009",plant
190,Gabon,0,0,0,6,0,6,50,104,160,314,1,45,"1,026",16,"1,402",plant
191,Gambia,0,0,0,0,0,0,0,1,7,8,0,2,365,1,376,plant
192,Ghana,0,0,0,0,0,0,3,31,93,127,1,24,"1,048",7,"1,207",plant
193,Guinea,0,0,0,14,0,14,32,87,75,194,1,31,909,13,"1,148",plant
194,Guinea-Bissau,0,0,0,0,0,0,1,1,10,12,0,8,524,2,546,plant
195,Kenya,0,0,0,2,0,2,29,127,169,325,1,75,"1,291",22,"1,714",plant
196,Lesotho,0,0,0,0,0,0,0,2,3,5,0,1,185,1,192,plant
197,Liberia,0,0,0,1,0,1,5,29,68,102,0,20,724,4,850,plant
198,Madagascar,0,1,1,101,7,109,499,"1,343",852,"2,694",0,212,"1,455",85,"4,447",plant
199,Malawi,0,0,0,0,0,0,1,21,24,46,1,11,"1,008",24,"1,090",plant
200,Mali,0,0,0,0,0,0,3,14,11,28,0,9,642,12,691,plant
201,Mauritania,0,0,0,0,0,0,0,0,0,0,0,2,234,0,236,plant
202,Mauritius,1,0,1,0,0,1,64,17,11,92,0,0,154,1,248,plant
203,Mayotte,0,0,0,0,0,0,0,6,4,10,0,0,78,0,88,plant
204,Mozambique,0,0,0,1,0,1,22,99,133,254,0,42,"1,261",50,"1,607",plant
205,Namibia,0,0,0,1,0,1,3,4,24,31,0,12,694,11,748,plant
206,Niger,0,0,0,0,0,0,0,1,3,4,0,2,386,3,395,plant
207,Nigeria,0,0,0,1,0,1,19,51,152,222,2,34,"1,343",12,"1,613",plant
208,Réunion,0,0,0,0,0,0,9,8,4,21,0,1,100,2,124,plant
209,Rwanda,0,1,1,3,0,4,4,52,56,112,1,17,670,7,808,plant
210,"Saint Helena, Ascension and Tristan da Cunha",8,2,10,0,0,10,27,6,11,44,0,1,26,5,86,plant
211,Sao Tome and Principe,2,0,2,0,0,2,1,21,32,54,0,13,166,0,235,plant
212,Senegal,2,0,2,0,0,2,1,9,14,24,0,9,737,7,779,plant
213,Seychelles,2,0,2,0,0,2,17,13,31,61,0,8,116,0,187,plant
214,Sierra Leone,1,0,1,1,0,2,8,37,77,122,1,26,811,9,970,plant
215,Somalia,0,0,0,0,0,0,3,23,30,56,0,44,419,12,531,plant
216,South Africa,2,3,5,7,3,15,63,115,136,314,2,121,"1,361",38,"1,841",plant
217,South Sudan,0,0,0,0,0,0,0,4,14,18,1,7,622,2,650,plant
218,Sudan,0,0,0,0,0,0,1,3,15,19,1,5,661,4,690,plant
219,"Tanzania, United Republic of",0,0,0,40,1,41,109,404,350,863,2,102,"1,744",63,"2,774",plant
220,Togo,0,0,0,0,0,0,0,3,11,14,0,6,722,1,743,plant
221,Uganda,0,0,0,3,0,3,8,34,66,108,1,26,"1,145",13,"1,293",plant
222,Zambia,0,0,0,0,0,0,3,15,18,36,0,19,"1,125",35,"1,215",plant
223,Zimbabwe,0,0,0,0,2,2,2,21,50,73,0,21,"1,116",19,"1,229",plant
224,Afghanistan,0,0,0,0,0,0,1,4,3,8,0,6,324,13,351,plant
225,Armenia,0,0,0,0,0,0,18,43,15,76,0,12,245,36,369,plant
226,Azerbaijan,0,0,0,0,0,0,7,18,21,46,0,18,262,25,351,plant
227,Bahrain,0,0,0,0,0,0,0,0,0,0,0,0,26,0,26,plant
228,Cyprus,0,0,0,0,0,0,7,5,11,23,0,10,230,11,274,plant
229,Georgia,0,0,0,0,0,0,9,17,39,65,0,13,319,27,424,plant
230,"Iran, Islamic Republic of",0,0,0,0,0,0,2,7,4,13,0,12,420,30,475,plant
231,Iraq,0,0,0,0,0,0,0,3,1,4,0,6,252,16,278,plant
232,Israel,0,0,0,0,0,0,3,23,13,39,0,9,282,9,339,plant
233,Jordan,0,0,0,0,0,0,0,5,3,8,0,4,191,7,210,plant
234,Kazakhstan,0,0,0,0,0,0,5,5,3,13,0,2,304,26,345,plant
235,Kuwait,0,0,0,0,0,0,0,0,0,0,0,1,29,0,30,plant
236,Kyrgyzstan,0,0,0,0,0,0,6,4,2,12,0,2,187,21,222,plant
237,Lebanon,0,0,0,5,0,5,17,61,22,100,0,11,315,19,445,plant
238,Oman,0,0,0,0,0,0,0,1,5,6,0,5,154,1,166,plant
239,Pakistan,0,0,0,0,0,0,4,6,7,17,0,7,480,20,524,plant
240,"Palestine, State of",0,0,0,0,0,0,1,6,4,11,0,6,224,5,246,plant
241,Qatar,0,0,0,0,0,0,0,0,0,0,0,0,31,0,31,plant
242,Saudi Arabia,0,0,0,0,0,0,0,3,1,4,0,0,259,0,263,plant
243,Syrian Arab Republic,0,0,0,0,0,0,5,25,14,44,0,14,307,28,393,plant
244,Tajikistan,0,0,0,0,0,0,6,3,2,11,0,2,190,19,222,plant
245,Turkey,0,0,0,0,0,0,67,42,23,132,0,31,651,71,885,plant
246,Turkmenistan,0,0,0,0,0,0,0,2,2,4,0,3,180,11,198,plant
247,United Arab Emirates,0,0,0,0,0,0,0,0,0,0,0,0,54,0,54,plant
248,Uzbekistan,0,0,0,0,0,0,4,7,3,14,0,1,198,16,229,plant
249,Yemen,3,0,3,0,0,3,6,28,129,163,0,23,426,32,647,plant
0,Antarctica,0,0,0,0,0,0,0,0,0,0,0,0,0,0,0,chromist
1,Bouvet Island,0,0,0,0,0,0,0,0,0,0,0,0,0,0,0,chromist
2,French Southern Territories,0,0,0,0,0,0,0,0,0,0,0,0,0,0,0,chromist
3,Heard Island and McDonald Islands,0,0,0,0,0,0,0,0,0,0,0,0,0,0,0,chromist
4,South Georgia and the South Sandwich Islands,0,0,0,0,0,0,0,0,0,0,0,0,0,0,0,chromist
5,Anguilla,0,0,0,0,0,0,0,0,0,0,0,0,0,0,0,chromist
6,Antigua and Barbuda,0,0,0,0,0,0,0,0,0,0,0,0,0,0,0,chromist
7,Aruba,0,0,0,0,0,0,0,0,0,0,0,0,0,0,0,chromist
8,Bahamas,0,0,0,0,0,0,0,0,0,0,0,0,0,0,0,chromist
9,Barbados,0,0,0,0,0,0,0,0,0,0,0,0,0,0,0,chromist
10,Bermuda,0,0,0,0,0,0,0,0,0,0,0,0,0,0,0,chromist
11,"Bonaire, Sint Eustatius and Saba",0,0,0,0,0,0,0,0,0,0,0,0,0,0,0,chromist
12,Cayman Islands,0,0,0,0,0,0,0,0,0,0,0,0,0,0,0,chromist
13,Cuba,0,0,0,0,0,0,0,0,0,0,0,0,0,0,0,chromist
14,Curaçao,0,0,0,0,0,0,0,0,0,0,0,0,0,0,0,chromist
15,Dominica,0,0,0,0,0,0,0,0,0,0,0,0,0,0,0,chromist
16,Dominican Republic,0,0,0,0,0,0,0,0,0,0,0,0,0,0,0,chromist
17,Grenada,0,0,0,0,0,0,0,0,0,0,0,0,0,0,0,chromist
18,Guadeloupe,0,0,0,0,0,0,0,0,0,0,0,0,0,0,0,chromist
19,Haiti,0,0,0,0,0,0,0,0,0,0,0,0,0,0,0,chromist
20,Jamaica,0,0,0,0,0,0,0,0,0,0,0,0,0,0,0,chromist
21,Martinique,0,0,0,0,0,0,0,0,0,0,0,0,0,0,0,chromist
22,Montserrat,0,0,0,0,0,0,0,0,0,0,0,0,0,0,0,chromist
23,Puerto Rico,0,0,0,0,0,0,0,0,0,0,0,0,0,0,0,chromist
24,Saint Barthélemy,0,0,0,0,0,0,0,0,0,0,0,0,0,0,0,chromist
25,Saint Kitts and Nevis,0,0,0,0,0,0,0,0,0,0,0,0,0,0,0,chromist
26,Saint Lucia,0,0,0,0,0,0,0,0,0,0,0,0,0,0,0,chromist
27,Saint Martin (French part),0,0,0,0,0,0,0,0,0,0,0,0,0,0,0,chromist
28,Saint Vincent and the Grenadines,0,0,0,0,0,0,0,0,0,0,0,0,0,0,0,chromist
29,Sint Maarten (Dutch part),0,0,0,0,0,0,0,0,0,0,0,0,0,0,0,chromist
30,Trinidad and Tobago,0,0,0,0,0,0,0,0,0,0,0,0,0,0,0,chromist
31,Turks and Caicos Islands,0,0,0,0,0,0,0,0,0,0,0,0,0,0,0,chromist
32,"Virgin Islands, British",0,0,0,0,0,0,0,0,0,0,0,0,0,0,0,chromist
33,"Virgin Islands, U.S.",0,0,0,0,0,0,0,0,0,0,0,0,0,0,0,chromist
34,China,0,0,0,0,0,0,0,0,0,0,0,0,0,0,0,chromist
35,Hong Kong,0,0,0,0,0,0,0,0,0,0,0,0,0,0,0,chromist
36,Japan,0,0,0,0,0,0,0,0,0,0,0,0,0,0,0,chromist
37,"Korea, Democratic People's Republic of",0,0,0,0,0,0,0,0,0,0,0,0,0,0,0,chromist
38,"Korea, Republic of",0,0,0,0,0,0,0,0,0,0,0,0,0,0,0,chromist
39,Macao,0,0,0,0,0,0,0,0,0,0,0,0,0,0,0,chromist
40,Mongolia,0,0,0,0,0,0,0,0,0,0,0,0,0,0,0,chromist
41,"Taiwan, Province of China",0,0,0,0,0,0,0,0,0,0,0,0,0,0,0,chromist
42,Åland Islands,0,0,0,0,0,0,0,0,0,0,0,0,0,0,0,chromist
43,Albania,0,0,0,0,0,0,0,0,0,0,0,0,0,0,0,chromist
44,Andorra,0,0,0,0,0,0,0,0,0,0,0,0,0,0,0,chromist
45,Austria,0,0,0,0,0,0,0,0,0,0,0,0,0,0,0,chromist
46,Belgium,0,0,0,0,0,0,0,0,0,0,0,0,0,0,0,chromist
47,Bosnia and Herzegovina,0,0,0,0,0,0,0,0,0,0,0,0,0,0,0,chromist
48,Bulgaria,0,0,0,0,0,0,0,0,0,0,0,0,0,0,0,chromist
49,Croatia,0,0,0,0,0,0,0,0,0,0,0,0,0,0,0,chromist
50,Czechia,0,0,0,0,0,0,0,0,0,0,0,0,0,0,0,chromist
51,Denmark,0,0,0,0,0,0,0,0,0,0,0,0,0,0,0,chromist
52,Estonia,0,0,0,0,0,0,0,0,0,0,0,0,0,0,0,chromist
53,Faroe Islands,0,0,0,0,0,0,0,0,0,0,0,0,0,0,0,chromist
54,Finland,0,0,0,0,0,0,0,0,0,0,0,0,0,0,0,chromist
55,France,0,0,0,0,0,0,0,0,0,0,0,0,0,0,0,chromist
56,Germany,0,0,0,0,0,0,0,0,0,0,0,0,0,0,0,chromist
57,Gibraltar,0,0,0,0,0,0,0,0,0,0,0,0,0,0,0,chromist
58,Greece,0,0,0,0,0,0,0,0,0,0,0,0,0,0,0,chromist
59,Greenland,0,0,0,0,0,0,0,0,0,0,0,0,0,0,0,chromist
60,Guernsey,0,0,0,0,0,0,0,0,0,0,0,0,0,0,0,chromist
61,Holy See (Vatican City State),0,0,0,0,0,0,0,0,0,0,0,0,0,0,0,chromist
62,Hungary,0,0,0,0,0,0,0,0,0,0,0,0,0,0,0,chromist
63,Iceland,0,0,0,0,0,0,0,0,0,0,0,0,0,0,0,chromist
64,Ireland,0,0,0,0,0,0,0,0,0,0,0,0,0,0,0,chromist
65,Isle of Man,0,0,0,0,0,0,0,0,0,0,0,0,0,0,0,chromist
66,Italy,0,0,0,0,0,0,0,0,0,0,0,0,0,0,0,chromist
67,Jersey,0,0,0,0,0,0,0,0,0,0,0,0,0,0,0,chromist
68,Latvia,0,0,0,0,0,0,0,0,0,0,0,0,0,0,0,chromist
69,Liechtenstein,0,0,0,0,0,0,0,0,0,0,0,0,0,0,0,chromist
70,Lithuania,0,0,0,0,0,0,0,0,0,0,0,0,0,0,0,chromist
71,Luxembourg,0,0,0,0,0,0,0,0,0,0,0,0,0,0,0,chromist
72,Malta,0,0,0,0,0,0,0,0,0,0,0,0,0,0,0,chromist
73,Monaco,0,0,0,0,0,0,0,0,0,0,0,0,0,0,0,chromist
74,Montenegro,0,0,0,0,0,0,0,0,0,0,0,0,0,0,0,chromist
75,Netherlands,0,0,0,0,0,0,0,0,0,0,0,0,0,0,0,chromist
76,North Macedonia,0,0,0,0,0,0,0,0,0,0,0,0,0,0,0,chromist
77,Norway,0,0,0,0,0,0,0,0,0,0,0,0,0,0,0,chromist
78,Poland,0,0,0,0,0,0,0,0,0,0,0,0,0,0,0,chromist
79,Portugal,0,0,0,0,0,0,0,0,0,0,0,0,0,0,0,chromist
80,Romania,0,0,0,0,0,0,0,0,0,0,0,0,0,0,0,chromist
81,San Marino,0,0,0,0,0,0,0,0,0,0,0,0,0,0,0,chromist
82,Serbia,0,0,0,0,0,0,0,0,0,0,0,0,0,0,0,chromist
83,Slovakia,0,0,0,0,0,0,0,0,0,0,0,0,0,0,0,chromist
84,Slovenia,0,0,0,0,0,0,0,0,0,0,0,0,0,0,0,chromist
85,Spain,0,0,0,0,0,0,0,0,0,0,0,0,0,0,0,chromist
86,Svalbard and Jan Mayen,0,0,0,0,0,0,0,0,0,0,0,0,0,0,0,chromist
87,Sweden,0,0,0,0,0,0,0,0,0,0,0,0,0,0,0,chromist
88,Switzerland,0,0,0,0,0,0,0,0,0,0,0,0,0,0,0,chromist
89,United Kingdom,0,0,0,0,0,0,0,0,0,0,0,0,0,0,0,chromist
90,Belize,0,0,0,0,0,0,0,0,0,0,0,0,0,0,0,chromist
91,Costa Rica,0,0,0,0,0,0,0,0,0,0,0,0,0,0,0,chromist
92,El Salvador,0,0,0,0,0,0,0,0,0,0,0,0,0,0,0,chromist
93,Guatemala,0,0,0,0,0,0,0,0,0,0,0,0,0,0,0,chromist
94,Honduras,0,0,0,0,0,0,0,0,0,0,0,0,0,0,0,chromist
95,Mexico,0,0,0,0,0,0,0,0,0,0,0,0,0,0,0,chromist
96,Nicaragua,0,0,0,0,0,0,0,0,0,0,0,0,0,0,0,chromist
97,Panama,0,0,0,0,0,0,0,0,0,0,0,0,0,0,0,chromist
98,Algeria,0,0,0,0,0,0,0,0,0,0,0,0,0,0,0,chromist
99,Egypt,0,0,0,0,0,0,0,0,0,0,0,0,0,0,0,chromist
100,Libya,0,0,0,0,0,0,0,0,0,0,0,0,0,0,0,chromist
101,Morocco,0,0,0,0,0,0,0,0,0,0,0,0,0,0,0,chromist
102,Tunisia,0,0,0,0,0,0,0,0,0,0,0,0,0,0,0,chromist
103,Western Sahara,0,0,0,0,0,0,0,0,0,0,0,0,0,0,0,chromist
104,Canada,0,0,0,0,0,0,0,0,0,0,0,0,0,0,0,chromist
105,Saint Pierre and Miquelon,0,0,0,0,0,0,0,0,0,0,0,0,0,0,0,chromist
106,United States,0,0,0,0,0,0,0,0,0,0,0,0,0,0,0,chromist
107,Belarus,0,0,0,0,0,0,0,0,0,0,0,0,0,0,0,chromist
108,Moldova,0,0,0,0,0,0,0,0,0,0,0,0,0,0,0,chromist
109,Russian Federation,0,0,0,0,0,0,0,0,0,0,0,0,0,0,0,chromist
110,Ukraine,0,0,0,0,0,0,0,0,0,0,0,0,0,0,0,chromist
111,American Samoa,0,0,0,0,0,0,0,0,0,0,0,0,0,0,0,chromist
112,Australia,0,0,0,0,0,0,0,0,0,0,0,0,0,0,0,chromist
113,Christmas Island,0,0,0,0,0,0,0,0,0,0,0,0,0,0,0,chromist
114,Cocos (Keeling) Islands,0,0,0,0,0,0,0,0,0,0,0,0,0,0,0,chromist
115,Cook Islands,0,0,0,0,0,0,0,0,0,0,0,0,0,0,0,chromist
116,Fiji,0,0,0,0,0,0,0,0,0,0,0,0,0,0,0,chromist
117,French Polynesia,0,0,0,0,0,0,0,0,0,0,0,0,0,0,0,chromist
118,Guam,0,0,0,0,0,0,0,0,0,0,0,0,0,0,0,chromist
119,Kiribati,0,0,0,0,0,0,0,0,0,0,0,0,0,0,0,chromist
120,Marshall Islands,0,0,0,0,0,0,0,0,0,0,0,0,0,0,0,chromist
121,"Micronesia, Federated States of",0,0,0,0,0,0,0,0,0,0,0,0,0,0,0,chromist
122,Nauru,0,0,0,0,0,0,0,0,0,0,0,0,0,0,0,chromist
123,New Caledonia,0,0,0,0,0,0,0,0,0,0,0,0,0,0,0,chromist
124,New Zealand,0,0,0,0,0,0,0,0,0,0,0,0,0,0,0,chromist
125,Niue,0,0,0,0,0,0,0,0,0,0,0,0,0,0,0,chromist
126,Norfolk Island,0,0,0,0,0,0,0,0,0,0,0,0,0,0,0,chromist
127,Northern Mariana Islands,0,0,0,0,0,0,0,0,0,0,0,0,0,0,0,chromist
128,Palau,0,0,0,0,0,0,0,0,0,0,0,0,0,0,0,chromist
129,Papua New Guinea,0,0,0,0,0,0,0,0,0,0,0,0,0,0,0,chromist
130,Pitcairn,0,0,0,0,0,0,0,0,0,0,0,0,0,0,0,chromist
131,Samoa,0,0,0,0,0,0,0,0,0,0,0,0,0,0,0,chromist
132,Solomon Islands,0,0,0,0,0,0,0,0,0,0,0,0,0,0,0,chromist
133,Tokelau,0,0,0,0,0,0,0,0,0,0,0,0,0,0,0,chromist
134,Tonga,0,0,0,0,0,0,0,0,0,0,0,0,0,0,0,chromist
135,Tuvalu,0,0,0,0,0,0,0,0,0,0,0,0,0,0,0,chromist
136,United States Minor Outlying Islands,0,0,0,0,0,0,0,0,0,0,0,0,0,0,0,chromist
137,Vanuatu,0,0,0,0,0,0,0,0,0,0,0,0,0,0,0,chromist
138,Wallis and Futuna,0,0,0,0,0,0,0,0,0,0,0,0,0,0,0,chromist
139,Argentina,0,0,0,0,0,0,0,0,0,0,0,0,0,0,0,chromist
140,"Bolivia, Plurinational States of",0,0,0,0,0,0,0,0,0,0,0,0,0,0,0,chromist
141,Brazil,0,0,0,0,0,0,0,0,0,0,0,0,0,0,0,chromist
142,Chile,0,0,0,0,0,0,0,0,0,0,0,0,0,0,0,chromist
143,Colombia,0,0,0,0,0,0,0,0,0,0,0,0,0,0,0,chromist
144,Ecuador,0,0,0,4,0,4,4,1,1,6,0,0,0,9,15,chromist
145,Falkland Islands (Malvinas),0,0,0,0,0,0,0,0,0,0,0,0,0,0,0,chromist
146,French Guiana,0,0,0,0,0,0,0,0,0,0,0,0,0,0,0,chromist
147,Guyana,0,0,0,0,0,0,0,0,0,0,0,0,0,0,0,chromist
148,Paraguay,0,0,0,0,0,0,0,0,0,0,0,0,0,0,0,chromist
149,Peru,0,0,0,0,0,0,0,0,0,0,0,0,0,0,0,chromist
150,Suriname,0,0,0,0,0,0,0,0,0,0,0,0,0,0,0,chromist
151,Uruguay,0,0,0,0,0,0,0,0,0,0,0,0,0,0,0,chromist
152,"Venezuela, Bolivarian Republic of",0,0,0,0,0,0,0,0,0,0,0,0,0,0,0,chromist
153,Bangladesh,0,0,0,0,0,0,0,0,0,0,0,0,0,0,0,chromist
154,Bhutan,0,0,0,0,0,0,0,0,0,0,0,0,0,0,0,chromist
155,British Indian Ocean Territory,0,0,0,0,0,0,0,0,0,0,0,0,0,0,0,chromist
156,Brunei Darussalam,0,0,0,0,0,0,0,0,0,0,0,0,0,0,0,chromist
157,Cambodia,0,0,0,0,0,0,0,0,0,0,0,0,0,0,0,chromist
158,Disputed Territory,0,0,0,0,0,0,0,0,0,0,0,0,0,0,0,chromist
159,India,0,0,0,0,0,0,0,0,0,0,0,0,0,0,0,chromist
160,Indonesia,0,0,0,0,0,0,0,0,0,0,0,0,0,0,0,chromist
161,Lao People's Democratic Republic,0,0,0,0,0,0,0,0,0,0,0,0,0,0,0,chromist
162,Malaysia,0,0,0,0,0,0,0,0,0,0,0,0,0,0,0,chromist
163,Maldives,0,0,0,0,0,0,0,0,0,0,0,0,0,0,0,chromist
164,Myanmar,0,0,0,0,0,0,0,0,0,0,0,0,0,0,0,chromist
165,Nepal,0,0,0,0,0,0,0,0,0,0,0,0,0,0,0,chromist
166,Philippines,0,0,0,0,0,0,0,0,0,0,0,0,0,0,0,chromist
167,Singapore,0,0,0,0,0,0,0,0,0,0,0,0,0,0,0,chromist
168,Sri Lanka,0,0,0,0,0,0,0,0,0,0,0,0,0,0,0,chromist
169,Thailand,0,0,0,0,0,0,0,0,0,0,0,0,0,0,0,chromist
170,Timor-Leste,0,0,0,0,0,0,0,0,0,0,0,0,0,0,0,chromist
171,Viet Nam,0,0,0,0,0,0,0,0,0,0,0,0,0,0,0,chromist
172,Angola,0,0,0,0,0,0,0,0,0,0,0,0,0,0,0,chromist
173,Benin,0,0,0,0,0,0,0,0,0,0,0,0,0,0,0,chromist
174,Botswana,0,0,0,0,0,0,0,0,0,0,0,0,0,0,0,chromist
175,Burkina Faso,0,0,0,0,0,0,0,0,0,0,0,0,0,0,0,chromist
176,Burundi,0,0,0,0,0,0,0,0,0,0,0,0,0,0,0,chromist
177,Cabo Verde,0,0,0,0,0,0,0,0,0,0,0,0,0,0,0,chromist
178,Cameroon,0,0,0,0,0,0,0,0,0,0,0,0,0,0,0,chromist
179,Central African Republic,0,0,0,0,0,0,0,0,0,0,0,0,0,0,0,chromist
180,Chad,0,0,0,0,0,0,0,0,0,0,0,0,0,0,0,chromist
181,Comoros,0,0,0,0,0,0,0,0,0,0,0,0,0,0,0,chromist
182,Congo,0,0,0,0,0,0,0,0,0,0,0,0,0,0,0,chromist
183,"Congo, The Democratic Republic of the",0,0,0,0,0,0,0,0,0,0,0,0,0,0,0,chromist
184,Côte d'Ivoire,0,0,0,0,0,0,0,0,0,0,0,0,0,0,0,chromist
185,Djibouti,0,0,0,0,0,0,0,0,0,0,0,0,0,0,0,chromist
186,Equatorial Guinea,0,0,0,0,0,0,0,0,0,0,0,0,0,0,0,chromist
187,Eritrea,0,0,0,0,0,0,0,0,0,0,0,0,0,0,0,chromist
188,Eswatini,0,0,0,0,0,0,0,0,0,0,0,0,0,0,0,chromist
189,Ethiopia,0,0,0,0,0,0,0,0,0,0,0,0,0,0,0,chromist
190,Gabon,0,0,0,0,0,0,0,0,0,0,0,0,0,0,0,chromist
191,Gambia,0,0,0,0,0,0,0,0,0,0,0,0,0,0,0,chromist
192,Ghana,0,0,0,0,0,0,0,0,0,0,0,0,0,0,0,chromist
193,Guinea,0,0,0,0,0,0,0,0,0,0,0,0,0,0,0,chromist
194,Guinea-Bissau,0,0,0,0,0,0,0,0,0,0,0,0,0,0,0,chromist
195,Kenya,0,0,0,0,0,0,0,0,0,0,0,0,0,0,0,chromist
196,Lesotho,0,0,0,0,0,0,0,0,0,0,0,0,0,0,0,chromist
197,Liberia,0,0,0,0,0,0,0,0,0,0,0,0,0,0,0,chromist
198,Madagascar,0,0,0,0,0,0,0,0,0,0,0,0,0,0,0,chromist
199,Malawi,0,0,0,0,0,0,0,0,0,0,0,0,0,0,0,chromist
200,Mali,0,0,0,0,0,0,0,0,0,0,0,0,0,0,0,chromist
201,Mauritania,0,0,0,0,0,0,0,0,0,0,0,0,0,0,0,chromist
202,Mauritius,0,0,0,0,0,0,0,0,0,0,0,0,0,0,0,chromist
203,Mayotte,0,0,0,0,0,0,0,0,0,0,0,0,0,0,0,chromist
204,Mozambique,0,0,0,0,0,0,0,0,0,0,0,0,0,0,0,chromist
205,Namibia,0,0,0,0,0,0,0,0,0,0,0,0,0,0,0,chromist
206,Niger,0,0,0,0,0,0,0,0,0,0,0,0,0,0,0,chromist
207,Nigeria,0,0,0,0,0,0,0,0,0,0,0,0,0,0,0,chromist
208,Réunion,0,0,0,0,0,0,0,0,0,0,0,0,0,0,0,chromist
209,Rwanda,0,0,0,0,0,0,0,0,0,0,0,0,0,0,0,chromist
210,"Saint Helena, Ascension and Tristan da Cunha",0,0,0,0,0,0,0,0,0,0,0,0,0,0,0,chromist
211,Sao Tome and Principe,0,0,0,0,0,0,0,0,0,0,0,0,0,0,0,chromist
212,Senegal,0,0,0,0,0,0,0,0,0,0,0,0,0,0,0,chromist
213,Seychelles,0,0,0,0,0,0,0,0,0,0,0,0,0,0,0,chromist
214,Sierra Leone,0,0,0,0,0,0,0,0,0,0,0,0,0,0,0,chromist
215,Somalia,0,0,0,0,0,0,0,0,0,0,0,0,0,0,0,chromist
216,South Africa,0,0,0,0,0,0,0,0,0,0,0,0,0,0,0,chromist
217,South Sudan,0,0,0,0,0,0,0,0,0,0,0,0,0,0,0,chromist
218,Sudan,0,0,0,0,0,0,0,0,0,0,0,0,0,0,0,chromist
219,"Tanzania, United Republic of",0,0,0,0,0,0,0,0,0,0,0,0,0,0,0,chromist
220,Togo,0,0,0,0,0,0,0,0,0,0,0,0,0,0,0,chromist
221,Uganda,0,0,0,0,0,0,0,0,0,0,0,0,0,0,0,chromist
222,Zambia,0,0,0,0,0,0,0,0,0,0,0,0,0,0,0,chromist
223,Zimbabwe,0,0,0,0,0,0,0,0,0,0,0,0,0,0,0,chromist
224,Afghanistan,0,0,0,0,0,0,0,0,0,0,0,0,0,0,0,chromist
225,Armenia,0,0,0,0,0,0,0,0,0,0,0,0,0,0,0,chromist
226,Azerbaijan,0,0,0,0,0,0,0,0,0,0,0,0,0,0,0,chromist
227,Bahrain,0,0,0,0,0,0,0,0,0,0,0,0,0,0,0,chromist
228,Cyprus,0,0,0,0,0,0,0,0,0,0,0,0,0,0,0,chromist
229,Georgia,0,0,0,0,0,0,0,0,0,0,0,0,0,0,0,chromist
230,"Iran, Islamic Republic of",0,0,0,0,0,0,0,0,0,0,0,0,0,0,0,chromist
231,Iraq,0,0,0,0,0,0,0,0,0,0,0,0,0,0,0,chromist
232,Israel,0,0,0,0,0,0,0,0,0,0,0,0,0,0,0,chromist
233,Jordan,0,0,0,0,0,0,0,0,0,0,0,0,0,0,0,chromist
234,Kazakhstan,0,0,0,0,0,0,0,0,0,0,0,0,0,0,0,chromist
235,Kuwait,0,0,0,0,0,0,0,0,0,0,0,0,0,0,0,chromist
236,Kyrgyzstan,0,0,0,0,0,0,0,0,0,0,0,0,0,0,0,chromist
237,Lebanon,0,0,0,0,0,0,0,0,0,0,0,0,0,0,0,chromist
238,Oman,0,0,0,0,0,0,0,0,0,0,0,0,0,0,0,chromist
239,Pakistan,0,0,0,0,0,0,0,0,0,0,0,0,0,0,0,chromist
240,"Palestine, State of",0,0,0,0,0,0,0,0,0,0,0,0,0,0,0,chromist
241,Qatar,0,0,0,0,0,0,0,0,0,0,0,0,0,0,0,chromist
242,Saudi Arabia,0,0,0,0,0,0,0,0,0,0,0,0,0,0,0,chromist
243,Syrian Arab Republic,0,0,0,0,0,0,0,0,0,0,0,0,0,0,0,chromist
244,Tajikistan,0,0,0,0,0,0,0,0,0,0,0,0,0,0,0,chromist
245,Turkey,0,0,0,0,0,0,0,0,0,0,0,0,0,0,0,chromist
246,Turkmenistan,0,0,0,0,0,0,0,0,0,0,0,0,0,0,0,chromist
247,United Arab Emirates,0,0,0,0,0,0,0,0,0,0,0,0,0,0,0,chromist
248,Uzbekistan,0,0,0,0,0,0,0,0,0,0,0,0,0,0,0,chromist
249,Yemen,0,0,0,0,0,0,0,0,0,0,0,0,0,0,0,chromist
0,Antarctica,0,0,0,0,0,0,0,0,0,0,0,0,0,0,0,fungus
1,Bouvet Island,0,0,0,0,0,0,0,0,0,0,0,0,0,0,0,fungus
2,French Southern Territories,0,0,0,0,0,0,0,0,0,0,0,0,0,0,0,fungus
3,Heard Island and McDonald Islands,0,0,0,0,0,0,0,0,0,0,0,0,0,0,0,fungus
4,South Georgia and the South Sandwich Islands,0,0,0,0,0,0,0,0,0,0,0,0,0,0,0,fungus
5,Anguilla,0,0,0,0,0,0,0,0,0,0,0,0,0,0,0,fungus
6,Antigua and Barbuda,0,0,0,0,0,0,0,0,0,0,0,0,0,0,0,fungus
7,Aruba,0,0,0,0,0,0,0,0,0,0,0,0,0,0,0,fungus
8,Bahamas,0,0,0,0,0,0,0,0,0,0,0,0,0,0,0,fungus
9,Barbados,0,0,0,0,0,0,0,0,0,0,0,0,0,0,0,fungus
10,Bermuda,0,0,0,0,0,0,0,0,0,0,0,0,0,0,0,fungus
11,"Bonaire, Sint Eustatius and Saba",0,0,0,0,0,0,0,0,0,0,0,0,0,0,0,fungus
12,Cayman Islands,0,0,0,0,0,0,0,0,0,0,0,0,0,0,0,fungus
13,Cuba,0,0,0,0,0,0,0,0,0,0,0,0,3,0,3,fungus
14,Curaçao,0,0,0,0,0,0,0,0,0,0,0,0,1,0,1,fungus
15,Dominica,0,0,0,0,0,0,0,0,0,0,0,0,0,0,0,fungus
16,Dominican Republic,0,0,0,0,0,0,0,0,0,0,0,0,1,0,1,fungus
17,Grenada,0,0,0,0,0,0,0,0,0,0,0,0,0,0,0,fungus
18,Guadeloupe,0,0,0,0,0,0,0,0,0,0,0,0,0,0,0,fungus
19,Haiti,0,0,0,0,0,0,0,0,0,0,0,0,0,0,0,fungus
20,Jamaica,0,0,0,0,0,0,0,0,0,0,0,0,1,0,1,fungus
21,Martinique,0,0,0,0,0,0,0,0,0,0,0,0,0,0,0,fungus
22,Montserrat,0,0,0,0,0,0,0,0,0,0,0,0,0,0,0,fungus
23,Puerto Rico,0,0,0,0,0,0,0,0,0,0,0,0,2,0,2,fungus
24,Saint Barthélemy,0,0,0,0,0,0,0,0,0,0,0,0,0,0,0,fungus
25,Saint Kitts and Nevis,0,0,0,0,0,0,0,0,0,0,0,0,0,0,0,fungus
26,Saint Lucia,0,0,0,0,0,0,0,0,0,0,0,0,0,0,0,fungus
27,Saint Martin (French part),0,0,0,0,0,0,0,0,0,0,0,0,0,0,0,fungus
28,Saint Vincent and the Grenadines,0,0,0,0,0,0,0,0,0,0,0,0,0,0,0,fungus
29,Sint Maarten (Dutch part),0,0,0,0,0,0,0,0,0,0,0,0,0,0,0,fungus
30,Trinidad and Tobago,0,0,0,0,0,0,0,0,0,0,0,0,0,0,0,fungus
31,Turks and Caicos Islands,0,0,0,0,0,0,0,0,0,0,0,0,0,0,0,fungus
32,"Virgin Islands, British",0,0,0,0,0,0,0,0,0,0,0,0,0,0,0,fungus
33,"Virgin Islands, U.S.",0,0,0,0,0,0,0,0,0,0,0,0,0,0,0,fungus
34,China,0,0,0,0,0,0,0,1,7,8,0,5,19,1,33,fungus
35,Hong Kong,0,0,0,0,0,0,0,0,0,0,0,0,1,0,1,fungus
36,Japan,0,0,0,0,0,0,0,4,8,12,0,9,25,2,48,fungus
37,"Korea, Democratic People's Republic of",0,0,0,0,0,0,0,1,1,2,0,0,13,0,15,fungus
38,"Korea, Republic of",0,0,0,0,0,0,0,1,2,3,0,4,17,0,24,fungus
39,Macao,0,0,0,0,0,0,0,0,0,0,0,0,0,0,0,fungus
40,Mongolia,0,0,0,0,0,0,0,1,3,4,0,0,6,1,11,fungus
41,"Taiwan, Province of China",0,0,0,0,0,0,0,1,1,2,0,1,8,0,11,fungus
42,Åland Islands,0,0,0,0,0,0,0,0,0,0,0,0,1,0,1,fungus
43,Albania,0,0,0,0,0,0,0,0,0,0,0,1,1,0,2,fungus
44,Andorra,0,0,0,0,0,0,0,0,0,0,0,0,23,0,23,fungus
45,Austria,0,0,0,0,0,0,0,6,40,46,0,21,39,1,107,fungus
46,Belgium,0,0,0,0,0,0,0,2,21,23,0,7,38,0,68,fungus
47,Bosnia and Herzegovina,0,0,0,0,0,0,0,0,1,1,0,1,4,0,6,fungus
48,Bulgaria,0,0,0,0,0,0,0,0,8,8,0,5,12,0,25,fungus
49,Croatia,0,0,0,0,0,0,0,5,19,24,0,8,19,1,52,fungus
50,Czechia,0,0,0,0,0,0,0,2,29,31,0,17,31,3,82,fungus
51,Denmark,0,0,0,0,0,0,0,2,27,29,0,11,38,0,78,fungus
52,Estonia,0,0,0,0,0,0,0,1,24,25,0,17,36,1,79,fungus
53,Faroe Islands,0,0,0,0,0,0,0,0,4,4,0,0,5,0,9,fungus
54,Finland,0,0,0,0,0,0,0,2,27,29,0,14,38,1,82,fungus
55,France,0,0,0,0,0,0,1,9,44,54,0,22,42,1,119,fungus
56,Germany,0,0,0,0,0,0,1,7,39,47,0,23,41,2,113,fungus
57,Gibraltar,0,0,0,0,0,0,0,0,0,0,0,0,0,0,0,fungus
58,Greece,0,0,0,0,0,0,0,3,4,7,0,2,12,0,21,fungus
59,Greenland,0,0,0,0,0,0,0,0,2,2,0,1,1,0,4,fungus
60,Guernsey,0,0,0,0,0,0,0,0,0,0,0,0,1,0,1,fungus
61,Holy See (Vatican City State),0,0,0,0,0,0,0,0,0,0,0,0,0,0,0,fungus
62,Hungary,0,0,0,0,0,0,0,3,15,18,0,8,20,1,47,fungus
63,Iceland,0,0,0,0,0,0,0,0,6,6,0,3,19,0,28,fungus
64,Ireland,0,0,0,0,0,0,0,2,17,19,0,3,29,0,51,fungus
65,Isle of Man,0,0,0,0,0,0,0,0,0,0,0,0,18,0,18,fungus
66,Italy,0,0,0,0,0,0,1,8,35,44,0,19,41,0,104,fungus
67,Jersey,0,0,0,0,0,0,0,0,1,1,0,1,0,0,2,fungus
68,Latvia,0,0,0,0,0,0,0,0,9,9,0,3,11,0,23,fungus
69,Liechtenstein,0,0,0,0,0,0,0,0,4,4,0,0,1,0,5,fungus
70,Lithuania,0,0,0,0,0,0,0,2,11,13,0,6,12,0,31,fungus
71,Luxembourg,0,0,0,0,0,0,0,0,2,2,0,1,29,0,32,fungus
72,Malta,0,0,0,0,0,0,0,0,1,1,0,1,1,0,3,fungus
73,Monaco,0,0,0,0,0,0,0,0,0,0,0,0,0,0,0,fungus
74,Montenegro,0,0,0,0,0,0,0,0,4,4,0,2,3,0,9,fungus
75,Netherlands,0,0,0,0,0,0,0,2,24,26,0,9,35,0,70,fungus
76,North Macedonia,0,0,0,0,0,0,0,2,5,7,0,2,3,0,12,fungus
77,Norway,0,0,0,0,0,0,2,6,34,42,0,19,40,1,102,fungus
78,Poland,0,0,0,0,0,0,0,4,24,28,0,18,32,2,80,fungus
79,Portugal,0,0,0,0,0,0,1,4,5,10,0,5,26,0,41,fungus
80,Romania,0,0,0,0,0,0,0,1,7,8,0,3,16,0,27,fungus
81,San Marino,0,0,0,0,0,0,0,0,0,0,0,0,0,0,0,fungus
82,Serbia,0,0,0,0,0,0,0,0,7,7,0,5,23,0,35,fungus
83,Slovakia,0,0,0,0,0,0,0,4,28,32,0,12,35,2,81,fungus
84,Slovenia,0,0,0,0,0,0,0,1,19,20,0,11,36,0,67,fungus
85,Spain,0,0,0,0,0,0,0,4,38,42,0,14,43,2,101,fungus
86,Svalbard and Jan Mayen,0,0,0,0,0,0,0,0,0,0,0,0,2,0,2,fungus
87,Sweden,0,0,0,0,0,0,1,5,39,45,0,25,41,1,112,fungus
88,Switzerland,0,0,0,0,0,0,1,5,34,40,0,19,34,1,94,fungus
89,United Kingdom,0,0,0,0,0,0,1,2,34,37,0,10,40,0,87,fungus
90,Belize,0,0,0,0,0,0,0,0,0,0,0,0,0,0,0,fungus
91,Costa Rica,0,0,0,0,0,0,0,0,4,4,0,5,5,0,14,fungus
92,El Salvador,0,0,0,0,0,0,0,0,0,0,0,0,1,0,1,fungus
93,Guatemala,0,0,0,0,0,0,0,0,1,1,0,0,1,0,2,fungus
94,Honduras,0,0,0,0,0,0,0,0,1,1,0,0,0,0,1,fungus
95,Mexico,0,0,0,0,0,0,1,1,4,6,0,3,19,1,29,fungus
96,Nicaragua,0,0,0,0,0,0,0,0,0,0,0,0,0,0,0,fungus
97,Panama,0,0,0,0,0,0,0,0,1,1,0,0,1,0,2,fungus
98,Algeria,0,0,0,0,0,0,0,0,2,2,0,1,3,0,6,fungus
99,Egypt,0,0,0,0,0,0,0,0,0,0,0,0,2,0,2,fungus
100,Libya,0,0,0,0,0,0,0,0,0,0,0,0,2,0,2,fungus
101,Morocco,0,0,0,0,0,0,0,1,4,5,0,2,4,0,11,fungus
102,Tunisia,0,0,0,0,0,0,0,1,1,2,0,0,2,0,4,fungus
103,Western Sahara,0,0,0,0,0,0,0,0,0,0,0,0,0,0,0,fungus
104,Canada,0,0,0,0,0,0,1,10,14,25,0,16,36,2,79,fungus
105,Saint Pierre and Miquelon,0,0,0,0,0,0,0,0,0,0,0,0,0,0,0,fungus
106,United States,0,0,0,1,0,1,12,30,30,72,0,19,43,6,140,fungus
107,Belarus,0,0,0,0,0,0,0,1,2,3,0,2,7,0,12,fungus
108,Moldova,0,0,0,0,0,0,0,0,0,0,0,0,2,0,2,fungus
109,Russian Federation,0,0,0,0,0,0,0,4,33,37,0,23,45,4,109,fungus
110,Ukraine,0,0,0,0,0,0,0,2,10,12,0,5,18,1,36,fungus
111,American Samoa,0,0,0,0,0,0,0,0,0,0,0,0,0,0,0,fungus
112,Australia,0,0,0,0,0,0,1,5,7,13,0,2,12,3,30,fungus
113,Christmas Island,0,0,0,0,0,0,0,0,0,0,0,0,0,0,0,fungus
114,Cocos (Keeling) Islands,0,0,0,0,0,0,0,0,0,0,0,0,0,0,0,fungus
115,Cook Islands,0,0,0,0,0,0,0,0,0,0,0,0,0,0,0,fungus
116,Fiji,0,0,0,0,0,0,0,0,0,0,0,0,0,0,0,fungus
117,French Polynesia,0,0,0,0,0,0,0,0,0,0,0,0,0,0,0,fungus
118,Guam,0,0,0,0,0,0,0,0,0,0,0,0,0,0,0,fungus
119,Kiribati,0,0,0,0,0,0,0,0,0,0,0,0,0,0,0,fungus
120,Marshall Islands,0,0,0,0,0,0,0,0,0,0,0,0,0,0,0,fungus
121,"Micronesia, Federated States of",0,0,0,0,0,0,0,0,0,0,0,0,0,0,0,fungus
122,Nauru,0,0,0,0,0,0,0,0,0,0,0,0,0,0,0,fungus
123,New Caledonia,0,0,0,0,0,0,1,3,0,4,0,1,0,1,6,fungus
124,New Zealand,0,0,0,0,0,0,2,9,2,13,0,4,13,10,40,fungus
125,Niue,0,0,0,0,0,0,0,0,0,0,0,0,0,0,0,fungus
126,Norfolk Island,0,0,0,0,0,0,0,0,0,0,0,0,0,0,0,fungus
127,Northern Mariana Islands,0,0,0,0,0,0,0,0,0,0,0,0,0,0,0,fungus
128,Palau,0,0,0,0,0,0,0,0,0,0,0,0,0,0,0,fungus
129,Papua New Guinea,0,0,0,0,0,0,0,3,0,3,0,0,1,1,5,fungus
130,Pitcairn,0,0,0,0,0,0,0,0,0,0,0,0,0,0,0,fungus
131,Samoa,0,0,0,0,0,0,0,0,0,0,0,0,0,0,0,fungus
132,Solomon Islands,0,0,0,0,0,0,0,0,0,0,0,0,0,0,0,fungus
133,Tokelau,0,0,0,0,0,0,0,0,0,0,0,0,0,0,0,fungus
134,Tonga,0,0,0,0,0,0,0,0,0,0,0,0,0,0,0,fungus
135,Tuvalu,0,0,0,0,0,0,0,0,0,0,0,0,0,0,0,fungus
136,United States Minor Outlying Islands,0,0,0,0,0,0,0,0,0,0,0,0,0,0,0,fungus
137,Vanuatu,0,0,0,0,0,0,0,0,0,0,0,0,0,0,0,fungus
138,Wallis and Futuna,0,0,0,0,0,0,0,0,0,0,0,0,0,0,0,fungus
139,Argentina,0,0,0,0,0,0,5,4,10,19,0,4,30,3,56,fungus
140,"Bolivia, Plurinational States of",0,0,0,0,0,0,0,0,0,0,0,0,1,0,1,fungus
141,Brazil,0,0,0,0,0,0,1,2,13,16,0,1,5,4,26,fungus
142,Chile,0,0,0,0,0,0,1,7,7,15,0,5,27,2,49,fungus
143,Colombia,0,0,0,0,0,0,1,0,4,5,0,5,8,0,18,fungus
144,Ecuador,0,0,0,0,0,0,0,0,1,1,0,0,4,0,5,fungus
145,Falkland Islands (Malvinas),0,0,0,0,0,0,0,0,6,6,0,0,0,0,6,fungus
146,French Guiana,0,0,0,0,0,0,0,0,0,0,0,1,1,0,2,fungus
147,Guyana,0,0,0,0,0,0,0,0,1,1,0,0,2,8,11,fungus
148,Paraguay,0,0,0,0,0,0,0,1,0,1,0,0,0,0,1,fungus
149,Peru,0,0,0,0,0,0,1,0,0,1,0,0,1,0,2,fungus
150,Suriname,0,0,0,0,0,0,0,0,0,0,0,0,0,0,0,fungus
151,Uruguay,0,0,0,0,0,0,0,0,0,0,0,0,3,0,3,fungus
152,"Venezuela, Bolivarian Republic of",0,0,0,0,0,0,0,0,1,1,0,0,4,0,5,fungus
153,Bangladesh,0,0,0,0,0,0,0,0,0,0,0,0,0,0,0,fungus
154,Bhutan,0,0,0,0,0,0,0,0,2,2,0,0,2,0,4,fungus
155,British Indian Ocean Territory,0,0,0,0,0,0,0,0,0,0,0,0,0,0,0,fungus
156,Brunei Darussalam,0,0,0,0,0,0,0,0,0,0,0,0,0,0,0,fungus
157,Cambodia,0,0,0,0,0,0,0,0,0,0,0,0,0,0,0,fungus
158,Disputed Territory,0,0,0,0,0,0,0,0,0,0,0,0,0,0,0,fungus
159,India,0,0,0,0,0,0,0,1,2,3,0,2,12,0,17,fungus
160,Indonesia,0,0,0,0,0,0,0,1,1,2,0,0,0,0,2,fungus
161,Lao People's Democratic Republic,0,0,0,0,0,0,0,0,1,1,0,0,0,0,1,fungus
162,Malaysia,0,0,0,0,0,0,0,2,2,4,0,0,1,1,6,fungus
163,Maldives,0,0,0,0,0,0,0,0,0,0,0,0,0,0,0,fungus
164,Myanmar,0,0,0,0,0,0,0,0,0,0,0,0,0,0,0,fungus
165,Nepal,0,0,0,0,0,0,0,0,2,2,0,0,3,0,5,fungus
166,Philippines,0,0,0,0,0,0,0,1,0,1,0,0,2,0,3,fungus
167,Singapore,0,0,0,0,0,0,0,0,0,0,0,0,1,0,1,fungus
168,Sri Lanka,0,0,0,0,0,0,0,0,0,0,0,0,1,0,1,fungus
169,Thailand,0,0,0,0,0,0,0,1,0,1,0,0,3,0,4,fungus
170,Timor-Leste,0,0,0,0,0,0,0,0,0,0,0,0,0,0,0,fungus
171,Viet Nam,0,0,0,0,0,0,0,0,0,0,0,0,1,0,1,fungus
172,Angola,0,0,0,0,0,0,0,0,0,0,0,0,0,0,0,fungus
173,Benin,0,0,0,0,0,0,0,0,0,0,0,0,1,0,1,fungus
174,Botswana,0,0,0,0,0,0,0,0,0,0,0,0,0,0,0,fungus
175,Burkina Faso,0,0,0,0,0,0,0,0,0,0,0,0,0,0,0,fungus
176,Burundi,0,0,0,0,0,0,0,0,0,0,0,0,0,0,0,fungus
177,Cabo Verde,0,0,0,0,0,0,0,0,0,0,0,0,1,0,1,fungus
178,Cameroon,0,0,0,0,0,0,0,0,0,0,0,0,0,0,0,fungus
179,Central African Republic,0,0,0,0,0,0,0,0,0,0,0,0,0,0,0,fungus
180,Chad,0,0,0,0,0,0,0,0,0,0,0,0,1,0,1,fungus
181,Comoros,0,0,0,0,0,0,0,0,0,0,0,0,0,0,0,fungus
182,Congo,0,0,0,0,0,0,0,0,0,0,0,0,0,0,0,fungus
183,"Congo, The Democratic Republic of the",0,0,0,0,0,0,0,0,0,0,0,0,2,0,2,fungus
184,Côte d'Ivoire,0,0,0,0,0,0,0,0,0,0,0,0,0,0,0,fungus
185,Djibouti,0,0,0,0,0,0,0,0,0,0,0,0,0,0,0,fungus
186,Equatorial Guinea,0,0,0,0,0,0,0,0,0,0,0,0,0,0,0,fungus
187,Eritrea,0,0,0,0,0,0,0,0,0,0,0,0,0,0,0,fungus
188,Eswatini,0,0,0,0,0,0,0,0,0,0,0,0,0,0,0,fungus
189,Ethiopia,0,0,0,0,0,0,0,0,0,0,0,0,0,0,0,fungus
190,Gabon,0,0,0,0,0,0,0,0,0,0,0,0,0,0,0,fungus
191,Gambia,0,0,0,0,0,0,0,0,0,0,0,0,0,0,0,fungus
192,Ghana,0,0,0,0,0,0,0,0,0,0,0,0,0,0,0,fungus
193,Guinea,0,0,0,0,0,0,0,0,0,0,0,0,0,0,0,fungus
194,Guinea-Bissau,0,0,0,0,0,0,0,0,0,0,0,0,0,0,0,fungus
195,Kenya,0,0,0,0,0,0,0,0,0,0,0,0,2,0,2,fungus
196,Lesotho,0,0,0,0,0,0,0,0,0,0,0,0,0,0,0,fungus
197,Liberia,0,0,0,0,0,0,0,0,0,0,0,0,0,0,0,fungus
198,Madagascar,0,0,0,0,0,0,0,0,0,0,0,0,0,0,0,fungus
199,Malawi,0,0,0,0,0,0,0,0,0,0,0,0,0,0,0,fungus
200,Mali,0,0,0,0,0,0,0,0,0,0,0,0,0,0,0,fungus
201,Mauritania,0,0,0,0,0,0,0,0,0,0,0,0,1,0,1,fungus
202,Mauritius,0,0,0,0,0,0,0,0,0,0,0,1,0,0,1,fungus
203,Mayotte,0,0,0,0,0,0,0,0,0,0,0,0,0,0,0,fungus
204,Mozambique,0,0,0,0,0,0,0,0,0,0,0,0,0,0,0,fungus
205,Namibia,0,0,0,0,0,0,0,0,0,0,0,0,1,0,1,fungus
206,Niger,0,0,0,0,0,0,0,0,0,0,0,0,0,0,0,fungus
207,Nigeria,0,0,0,0,0,0,0,0,0,0,0,0,1,0,1,fungus
208,Réunion,0,0,0,0,0,0,0,0,0,0,0,0,0,0,0,fungus
209,Rwanda,0,0,0,0,0,0,0,0,0,0,0,0,0,0,0,fungus
210,"Saint Helena, Ascension and Tristan da Cunha",0,0,0,0,0,0,0,0,1,1,0,0,0,0,1,fungus
211,Sao Tome and Principe,0,0,0,0,0,0,0,0,0,0,0,0,0,0,0,fungus
212,Senegal,0,0,0,0,0,0,0,0,0,0,0,0,0,0,0,fungus
213,Seychelles,0,0,0,0,0,0,0,0,0,0,0,0,0,0,0,fungus
214,Sierra Leone,0,0,0,0,0,0,0,0,0,0,0,0,0,0,0,fungus
215,Somalia,0,0,0,0,0,0,0,0,0,0,0,0,0,0,0,fungus
216,South Africa,0,0,0,0,0,0,0,0,0,0,0,0,7,0,7,fungus
217,South Sudan,0,0,0,0,0,0,0,0,0,0,0,0,0,0,0,fungus
218,Sudan,0,0,0,0,0,0,0,0,0,0,0,0,1,0,1,fungus
219,"Tanzania, United Republic of",0,0,0,0,0,0,0,0,0,0,0,0,0,0,0,fungus
220,Togo,0,0,0,0,0,0,0,0,0,0,0,0,1,0,1,fungus
221,Uganda,0,0,0,0,0,0,0,0,0,0,0,0,0,0,0,fungus
222,Zambia,0,0,0,0,0,0,0,0,0,0,0,0,1,0,1,fungus
223,Zimbabwe,0,0,0,0,0,0,0,0,0,0,0,0,0,0,0,fungus
224,Afghanistan,0,0,0,0,0,0,0,0,0,0,0,0,2,0,2,fungus
225,Armenia,0,0,0,0,0,0,0,0,0,0,0,0,4,0,4,fungus
226,Azerbaijan,0,0,0,0,0,0,0,0,0,0,0,0,3,0,3,fungus
227,Bahrain,0,0,0,0,0,0,0,0,0,0,0,0,0,0,0,fungus
228,Cyprus,0,0,0,0,0,0,0,0,1,1,0,1,1,0,3,fungus
229,Georgia,0,0,0,0,0,0,0,0,4,4,0,1,9,0,14,fungus
230,"Iran, Islamic Republic of",0,0,0,0,0,0,0,0,0,0,0,0,2,0,2,fungus
231,Iraq,0,0,0,0,0,0,0,0,0,0,0,0,1,0,1,fungus
232,Israel,0,0,0,0,0,0,0,0,1,1,0,1,4,0,6,fungus
233,Jordan,0,0,0,0,0,0,0,0,0,0,0,0,0,0,0,fungus
234,Kazakhstan,0,0,0,0,0,0,0,0,1,1,0,3,4,1,9,fungus
235,Kuwait,0,0,0,0,0,0,0,0,0,0,0,0,1,0,1,fungus
236,Kyrgyzstan,0,0,0,0,0,0,0,0,0,0,0,0,2,0,2,fungus
237,Lebanon,0,0,0,0,0,0,0,0,0,0,0,0,0,0,0,fungus
238,Oman,0,0,0,0,0,0,0,0,0,0,0,0,0,0,0,fungus
239,Pakistan,0,0,0,0,0,0,0,0,0,0,0,1,4,0,5,fungus
240,"Palestine, State of",0,0,0,0,0,0,0,0,0,0,0,0,1,0,1,fungus
241,Qatar,0,0,0,0,0,0,0,0,0,0,0,0,1,0,1,fungus
242,Saudi Arabia,0,0,0,0,0,0,0,0,0,0,0,0,1,0,1,fungus
243,Syrian Arab Republic,0,0,0,0,0,0,0,0,0,0,0,0,1,0,1,fungus
244,Tajikistan,0,0,0,0,0,0,0,0,1,1,0,0,2,0,3,fungus
245,Turkey,0,0,0,0,0,0,0,0,7,7,0,3,8,0,18,fungus
246,Turkmenistan,0,0,0,0,0,0,0,0,0,0,0,0,3,0,3,fungus
247,United Arab Emirates,0,0,0,0,0,0,0,0,0,0,0,0,0,0,0,fungus
248,Uzbekistan,0,0,0,0,0,0,0,0,0,0,0,0,5,0,5,fungus
249,Yemen,0,0,0,0,0,0,0,0,0,0,0,0,1,0,1,fungus
